a	một
a bit	một chút, một tí
a few	một ít, một vài
a little	nhỏ, một ít
abandon	bỏ, từ bỏ
abandoned	bị bỏ rơi, bị ruồng bỏ
ability	khả năng, năng lực
able	có năng lực, có tài
abortion	sự phá thai
about	khoảng, về
above	ở trên, lên trên
abroad	ở, ra nước ngoài, ngoài trời
absence	sự vắng mặt
absent	vắng mặt, nghỉ
absolute	tuyệt đối, hoàn toàn
absolutely	tuyệt đối, hoàn toàn
absorb	thu hút, hấp thu, lôi cuốn
abstract	trừu tượng
abuse	lộng hành, lạm dụng
academic	thuộc học viện, đh, viện hàn lâm
accelerate	đẩy nhanh
accent	trọng âm, dấu trọng âm
accept	chấp nhận, chấp thuận
acceptable	có thể chấp nhận, chấp thuận
acceptance	chấp thuận
access	lối, cửa, đường vào
accessible	có thể truy cập
accident	tai nạn, rủi ro
accidental	tình cờ, bất ngờ
accidentally	tình cờ, ngẫu nhiên
accommodate	chứa
accommodation	sự thích nghi, điều tiết
accompany	đi theo, đi cùng, kèm theo
accomplish	hoàn thành
accomplishment	hoàn thành
according	theo
according to	theo, y theo
account	tài khoản, kế toán, tính toán, tính đến
accountability	trách nhiệm giải trình
accounting	kế toán
accuracy	tính chính xác
accurate	đúng đắn, chính xác, xác đáng
accurately	đúng đắn, chính xác
accusation	tố cáo
accuse	tố cáo, buộc tội, kết tội
achieve	đạt được, dành được
achievement	thành tích, thành tựu
acid	axit
acknowledge	công nhận, thừa nhận
acquire	dành được, đạt được, kiếm được
acquisition	mua lại
across	qua, ngang qua
act	hành động, hành vi, cử chỉ, đối xử
action	hành động, hành vi, tác động
active	tích cực hoạt động, nhanh nhẹn
actively	tích cực
activist	nhà hoạt động
activity	hoạt động
actor	diễn viên
actress	diễn viên
actual	thực tế, có thật
actually	hiện nay, hiện tại
ad	quảng cáo
adapt	tra, lắp vào
add	cộng, thêm vào
added	thêm
addition	tính cộng, phép cộng
additional	thêm vào, tăng thêm
address	địa chỉ, đề địa chỉ
adequate	đầy, đầy đủ
adequately	tương xứng, thỏa đáng
adjust	sửa lại cho đúng, điều chỉnh
adjustment	điều chỉnh
administer	quản lý
administration	quản trị
administrative	hành chính
administrator	người quản lý
admiration	sự khâm phục,người kp, thán phục
admire	khâm phục, thán phục
admission	nhận vào
admit	nhận vào, cho vào, kết hợp
adolescent	thanh niên
adopt	nhận làm con nuôi, bố mẹ nuôi
adoption	nhận con nuôi
adult	người lớn, người trưởng thành, trưởng thành
advance	sự tiến bộ, tiến lên, đưa lên, đề xuất
advanced	tiên tiến, tiến bộ, cấp cao
advantage	sự thuận lợi, lợi ích, lợi thế
adventure	sự phiêu lưu, mạo hiểm
advertise	báo cho biết, báo cho biết trước
advertisement	quảng cáo
advertising	sự quảng cáo, nghề quảng cáo
advice	lời khuyên, lời chỉ bảo
advise	khuyên, khuyên bảo, răn bảo
adviser	cố vấn
advocate	biện hộ
aesthetic	thẩm mỹ
affair	việc
affect	làm ảnh hưởng, tác động đến
afford	có thể, có đủ khả năng, điều kiện
afraid	sợ, sợ hãi, hoảng sợ
african	châu phi
african-american	người mỹ gốc phi
after	sau, đằng sau, sau khi
afternoon	buổi chiều
afterward	sau đó
afterwards	sau này, về sau, rồi thì, sau đấy
again	lại, nữa, lần nữa
against	chống lại, phản đối
age	tuổi
aged	già đi
agency	tác dụng, lực, môi giới, trung gian
agenda	chương trình nghị sự
agent	đại lý, tác nhân
aggression	hiếu chiến
aggressive	xâm lược, hung hăng
ago	trước đây
agree	đồng ý, tán thành
agreement	sự đồng ý, tán thành, hiệp định, hợp đồng
agricultural	nông nghiệp
agriculture	nông nghiệp
ah	ah
ahead	trước, về phía trước
aid	sự giúp đỡ, thêm vào, phụ vào
aide	trợ lý
aids	AIDS
aim	sự nhắm , mục tiêu, ý định, nhắm, tập trung, hướng vào
air	không khí, bầu không khí, không gian
aircraft	máy bay, khí cầu
airline	hãng hàng không
airplane	máy bay
airport	sân bay
aisle	lối đi
alarm	báo động, báo nguy
alarming	làm lo sợ, làm hốt hoảng, làm sợ hãi
album	album
alcohol	rượu cồn
alcoholic	rượu, người nghiện rượu
alien	người ngoài hành tinh
alike	như nhau
alive	sống, vẫn còn sống, còn tồn tại
all	tất cả
all right	tốt, ổn, khỏe mạnh, được
allegation	cáo buộc
alleged	cáo buộc
allegedly	bị cáo buộc
alley	hẻm
alliance	liên minh
allied	lien minh, đồng minh, thông
allow	cho phép, để cho
ally	nước đồng minh, liên minh, liên kết, lien minh, kết thông gia
almost	hầu hết
alone	cô đơn, một mình
along	dọc theo, theo, theo chiều dài, suốt theo
alongside	sát cạnh, kế bên, dọc theo
aloud	lớn tiếng, to tiếng
alphabet	bảng chữ cái, bước đầu, điều cơ bản
alphabetical	thuộc bảng chứ cái
alphabetically	theo thứ tự abc
already	đã, rồi, đã… rồi
also	cũng, cũng vậy, cũng thế
alter	thay đổi, biến đổi, sửa đổi
alternative	sự lựa chọn, lựa chọn
although	mặc dù, dẫu cho
altogether	hoàn toàn, hầu như, nói chung
aluminum	nhôm
always	luôn luôn
am	lÀ
amaze	làm ngạc nhiên, làm sửng sốt
amazed	kinh ngạc, sửng sốt
amazing	kinh ngạc, sửng sốt
ambassador	đại sứ
ambition	hoài bão, khát vọng
ambitious	đầy tham vọng
ambulance	xe cứu thương, xe cấp cứu
amendment	sửa đổi
american	người mỹ
amid	giữa
among	giữa, ở giữa
amount	số lượng, số nhiều, lên tới
amuse	làm cho vui, thích, làm buồn cười
amused	vui thích
amusing	vui thích
analyse	phân tích
analysis	sự phân tích
analyst	nhà phân tích
analyze	phân tích
ancestor	tổ tiên
ancient	xưa, cổ
and	và
and/or	và / hoặc
angel	thiên thần
anger	sự tức giận, sự giận dữ
angle	góc
angrily	tức giận, giận dữ
angry	giận, tức giận
animal	động vật, thú vật
ankle	mắt cá chân
anniversary	ngày, lễ kỉ niệm
announce	báo, thông báo
announcement	thông báo
annoy	chọc tức, làm bực mình, làm phiền, quẫy nhiễu
annoyed	bị khó chịu, bực mình, bị quấy rầy
annoying	chọc tức, làm bực mình, làm phiền, quẫy nhiễu
annual	hàng năm, từng năm
annually	hàng năm, từng năm
anonymous	vô danh
another	khác
answer	sự trả lời, trả lời
anti- prefix	chống lại
anticipate	thấy trước, chặn trước, lường trước
anxiety	mối lo âu, sự lo lắng
anxious	lo âu, lo lắng, băn khoăn
anxiously	lo âu, lo lắng, băn khoăn
any	một người, vật nào đó, bất cứ, một chút nào, tí nào
anybody	bất kỳ ai
anymore	nữa không
anyone	người nào, bất cứ ai
anything	việc gì, vật gì, bất cứ việc gì, vật gì
anyway	thế nào cũng được, dù sao chăng nữa
anywhere	bất cứ chỗ nào, bất cứ nơi đâu
apart	về một bên, qua một bên
apart from	ngoài… ra
apartment	căn phòng, căn buồng
apologize	xin lỗi, tạ lỗi
apology	xin lỗi
apparent	rõ ràng, rành mạch, bề ngoài, có vẻ
apparently	nhìn bên ngoài, hình như
appeal	sự kêu gọi, lời kêu gọi, kêu gọi, cầu khẩn
appear	xuất hiện, hiện ra, trình diện
appearance	sự xuất hiện, sự trình diện
apple	quả táo
application	sự gắn vào, vật gắn vào, sự chuyên cần, chuyên tâm
apply	gắn vào, ghép vào, áp dụng vào
appoint	bổ nhiệm, chỉ định, chọn
appointment	sự bổ nhiệm, người được bổ nhiệm
appreciate	thấy rõ, nhận thức
appreciation	sự đánh giá
approach	đến gần, lại gần, sự đến gần, sự lại gần
appropriate	thích hợp, thích đáng
approval	sự tán thành, đồng ý, sự chấp thuận
approve	tán thành, đồng ý, chấp thuận
approving	tán thành, đồng ý, chấp thuận
approximate	giống với, giống hệt với
approximately	khoảng chừng, độ chừng
april	tháng tư
arab	arab
architect	kiến trúc sư
architecture	kiến trúc
area	diện tích, bề mặt
arena	đấu trường
argue	chứng tỏ, chỉ rõ
argument	lý lẽ
arise	xuất hiện, nảy ra, nảy sinh ra
arm	cánh tay, vũ trang, trang bị
armed	vũ trang
arms	vũ khí, binh giới, binh khí
army	quân đội
around	xung quanh, vòng quanh
arrange	sắp xếp, sắp đặt, sửa soạn
arrangement	sự sắp xếp, sắp đặt, sự sửa soạn
array	mảng
arrest	bắt giữ, sự bắt giữ
arrival	sự đến, sự tới nơi
arrive	đến nơi
arrow	tên, mũi tên
art	nghệ thuật, mỹ thuật
article	bài báo, đề mục
articulate	khớp nối
artifact	đồ tạo tác
artificial	nhân tạo
artificially	nhân tạo
artist	nghệ sĩ
artistic	thuộc nghệ thuật, thuộc mỹ thuật
as	như
as soon as	ngay khi
as well	cũng, cũng như
ash	tro
ashamed	ngượng, xấu hổ
asian	châu Á
aside	về một bên, sang một bên
aside from	ngoài ra, trừ ra
ask	hỏi
asleep	ngủ, đang ngủ
aspect	vẻ bề ngoài, diện mạo
ass	mông
assault	tấn công
assemble	tập hợp
assembly	hội,, tổ hợp
assert	khẳng định
assess	đánh giá
assessment	thẩm định, lượng định, đánh giá
asset	tài sản
assign	chỉ định
assignment	nhiệm vụ
assist	giúp, giúp đỡ, tham dự, có mặt
assistance	sự giúp đỡ
assistant	người giúp đỡ, người phụ tá, giúp đỡ, phụ tá
associate	kết giao, liên kết, kết hợp, cho cộng tác
associated	liên kết
associated with	liên kết với
association	sự kết hợp, sự liên kết
assume	mang, khoác, có, lấy
assumption	giả thiết
assure	đảm bảo, cam đoan
astronomer	nhà thiên văn học
at	tại
at first	trực tiếp
at least	ít ra, ít nhất, chí ít
athlete	lực sĩ
athletic	khỏe mạnh
atmosphere	khí quyển
atom	nguyên tử
atop	trên
attach	gắn, dán, trói, buộc
attached	gắn bó
attack	sự tấn công, sự công kích, tấn công, công kích
attempt	sự cố gắng, sự thử, cố gắng, thử
attempted	cố gắng, thử
attend	dự, có mặt
attendance	sự tham dự
attention	sự chú ý
attitude	thái độ, quan điểm
attorney	người được ủy quyền
attract	hút, thu hút, hấp dẫn
attraction	sự hút, sức hút
attractive	hút, thu hút, có duyên, lôi cuốn
attribute	thuộc tính
auction	bán đấu giá
audience	thính, khan giả
august	tháng tám
aunt	cô, dì
author	tác giả
authority	uy quyền, quyền lực
authorize	cho phép
auto	tự động
automatic	tự động
automatically	tự động
automobile	ôtô
autonomy	tự trị
autumn	mùa thu
availability	khả dụng
available	có thể dùng được, có giá trị, hiệu lực
average	trung bình, số trung bình, mức trung bình
avoid	tránh, tránh xa
await	chờ đợi
awake	đánh thức, làm thức dậy
award	phần thưởng, tặng, thưởng
aware	biết, nhận thức, nhận thức thấy
awareness	nhận thức
away	xa, xa cách, rời xa, đi xa
awful	oai nghiêm, dễ sợ
awkward	vụng về, lung túng
baby	đứa bé
back	lưng, về phía sau, trở lại
background	phía sau, nền
backward	về phía sau, lùi lại
backyard	sân sau
bacteria	vi khuẩn
bad	xấu, tồi
bad-tempered	xấu tính, dễ nổi cáu
badly	xấu, tồi
bag	bao, túi, cặp xách
baggage	hành lý
bake	nung, nướng bằng lò
balance	cái cân, làm cho cân bằng, tương xứng
balanced	cân bằng
ball	quả bóng
balloon	quả bóng bay
ballot	phiếu
ban	cấm, cấm chỉ, sự cấm
banana	trái chuối
band	băng, đai, nẹp
bandage	dải băng, băng bó
bank	bờ  , đê
banker	chủ ngân hàng
banking	ngân hàng
bankruptcy	phá sản
bar	quán bán rượu
bare	trần
barely	vừa đủ
bargain	sự mặc cả, sự giao kèo mua bán
barn	chuồng trại
barrel	thùng
barrier	đặt chướng ngại vật
base	cơ sở, cơ bản, nền móng, đặt tên, đặt cơ sở trên cái gì
baseball	bóng chày
basement	tầng hầm
basic	cơ bản, cơ sở
basically	cơ bản, về cơ bản
basis	nền tảng, cơ sở
basket	cái rổ
basketball	bóng rổ
bat	gậy
bath	sự tắm
bathroom	buồng tắm, nhà vệ sinh
battery	pin, ắc quy
battle	trận đánh, chiến thuật
bay	gian , bays: vòng nguyệt quế
be	được
be going to	sắp sửa, có ý định
be sick	bị ốm
beach	bãi biển
beak	mỏ chim
beam	chùm tia
bean	hạt đậu
bear	mang, cầm, vác, đeo, ôm
beard	râu
beast	quái thú
beat	tiếng đập, sự đập, đánh đập, đấm
beautiful	đẹp
beautifully	tốt đẹp, đáng hài lòng
beauty	vẻ đẹp, cái đẹp, người đẹp
because	bởi vì, vìbecause of prep. vì, do bởi
become	trở thành, trở nên
bed	cái giường
bedroom	phòng ngủ
bee	con ong
beef	thịt bò
beer	rượu bia
before	trước, đằng trước
beg	ăn xin
begin	bắt đầu, khởi đầu
beginning	phần đầu, lúc bắt đầu, lúc khởi đầu
behalf	sự thay mặt
behave	đối xử, ăn ở, cư xử
behavior	hành vi
behavioral	hành vi
behind	sau, ở đằng sau
being	đang
belief	lòng tin, đức tin, sự tin tưởng
believe	tin, tin tưởng
bell	cái chuông, tiếng chuông
belly	bụng
belong	thuộc về, của, thuộc quyền sở hữu
below	ở dưới, dưới thấp, phía dưới
belt	dây lưng, thắt lưng
bench	băng ghế
bend	chỗ rẽ, chỗ uốn, khuỷu tay, cúi xuống, uốn cong
beneath	ở dưới, dưới thấp
benefit	lợi, lợi ích, giúp ích, làm lợi cho
bent	khiếu, sở thích, khuynh hướng
beside	bên cạnh, so với
besides	ngoài ra
best	tốt
bet	đánh cuộc, cá cược, sự đánh cuộc
better	tốt hơn
betting	sự đánh cuộc
between	giữa, ở giữa
beyond	ở xa, phía bên kia
bias	sự thiên vị
bible	kinh thánh
bicycle	xe đạp
bid	đặt giá, trả giá, sự đặt giá, sự trả giá
big	to, lớn
bike	xe đạp
bill	hóa đơn, giấy bạc
billion	tỷ
bin	thùng, thùng đựng rượu
bind	trói buộc
biography	tiểu sử
biological	sinh học
biology	sinh vật học
bird	chim
birth	sự ra đời, sự sinh đẻ
birthday	ngày sinh, sinh nhật
biscuit	bánh quy
bishop	giám mục
bit	miếng, mảnh
bite	cắn, ngoạm, sự cắn, sự ngoạm
bitter	đắng, đắng cay, chua xót
bitterly	đắng, đắng cay, chua xót
black	đen, màu đen
blade	lưỡi
blame	khiển trách, mắng trách, sự khiển trách, sự mắng trách
blank	trống, để trắng, sự trống rỗng
blanket	cái mền
blankly	ngây ra, không có thần
blast	vụ nổ
blend	trộn
bless	ban phước
blessing	phước lành
blind	đui, mù
blink	chớp mắt
block	khối, tảng , làm ngăn cản, ngăn chặn
blond	tóc vàng
blonde	hoe vàng, mái tóc hoe vàng
blood	máu, huyết, sự tàn sát, chem giết
bloody	dính máu
blow	nở hoa, sự nở hoa
blue	xanh, màu xanh
board	tấm ván, lát ván, lót ván
boast	khoe khoan
boat	tàu, thuyền
body	thân thể, thân xác
boil	sôi, luộc
bold	dũng cảm
bolt	chớp
bomb	quả bom, oánh bom, thả bom
bombing	ném bom
bond	liên kết
bone	xương
bonus	thưởng
book	sách, ghi chép
boom	sự bùng nổ
boost	tăng
boot	giày ống
booth	gian hàng
border	bờ, mép, vỉa, lề
bore	buồn chán, buồn tẻ
boring	buồn chán
born	sinh ra
born: be born	sinh, đẻ
borrow	vay, mượn
boss	ông chủ, thủ trưởng
both	cả hai
bother	làm phiền, quấy rầy, làm bực mình
bottle	chai, lọ
bottom	phần dưới cùng, thấp nhất, cuối, cuối cùng
bounce	tung lên
bound	nhất định, chắc chắn
boundary	ranh giới
bow	cây cung
bowl	cái bát
box	hộp, thùng
boy	con trai, thiếu niên
boyfriend	bạn trai
brain	óc não, đầu óc, trí não
brake	phanh
branch	ngành, nhành cây, nhánh song, ngả đường
brand	nhãn
brave	gan dạ, can đảm
bread	bánh mỳ
break	bẻ gãy, đập vỡ, sự gãy, sự vỡ
breakfast	bữa điểm tâm, bữa sáng
breast	ngực, vú
breath	hơi thở, hơi
breathe	hít, thở
breathing	sự hô hấp, sự thở
breed	nuôi dưỡng, chăm sóc, giáo dục, sinh đẻ, nòi giống
breeze	khoe khoang
brick	gạch
bride	cô dâu
bridge	cái cầu
brief	ngắn, gọn, vắn tắt
briefly	ngắn, gọn, vắn tắt, tóm tắt
bright	sáng, sáng chói
brightly	sáng chói, tươi
brilliant	tỏa sáng, rực rỡ, chói lọi
bring	mang, cầm , xách lại
british	người anh
broad	rộng
broadcast	tung ra khắp nơi,truyền rộng rãi, phát thanh, quảng bá
broadly	rộng, rộng rãi
broken	bị gãy, bị vỡ
broker	người môi giới
bronze	đồng
brother	anh, em trai
brown	nâu, màu nâu
brush	bàn chải, chải, quét
brutal	tàn bạo
bubble	bong bóng, bọt, tăm
buck	buck
bucket	cái xô
buddy	bạn bè
budget	ngân sách
bug	lỗi
build	xây dựng
builder	người xây dựng
building	sự xây dựng, công trình xây dựng, tòa nhà binđinh
bulb	bóng đèn
bulk	số lượng lớn
bull	con bò
bullet	đạn
bunch	búi, chùm, bó, cụm, buồng, bầy, đàn
burden	gánh nặng
bureau	phòng làm việc
burn	đốt, đốt cháy, thắp, nung, thiêu
burning	đốt
burnt	bị đốt, bị cháy, khê, rám nắng, sạm
burst	nổ, nổ tung , háo hức
bury	chôn cất, mai táng
bus	xe buýt
bush	bụi cây, bụi rậm
business	việc buôn bán, thương mại, kinh doanh
businessman	doanh nhân
busy	bận, bận rộn
but	nhưng
butt	mông
butter	bơ
butterfly	con bướm
button	cái nút, cái khuy, cúc
buy	mua
buyer	người mua
by	bởi, bằng
by means of	bằng phương tiện
bye exclamation	tạm biệt
c	rack  bẻ khóa
cab	taxi
cabin	cabin
cabinet	tủ có nhiều ngăn đựng đồ
cable	dây cáp
cage	cái lồng
cake	bánh ngọt
calculate	tính toán
calculation	sự tính toán
calendar	lịch
call	gọi, tiếng kêu, tiếng gọi
calm	yên lặng, làm dịu đi, sự yên lặng, sự êm ả
calmly	yên lặng, êm ả, bình tĩnh, điềm tĩnh
camera	máy ảnh
camp	trại, chỗ cắm trại, cắm trại, hạ trại
campaign	chiến dịch, cuộc vận động
camping	sự cắm trại
campus	khuôn viên
can	có thể
can modal	có thể, nhà tù, nhà giam, bình, ca đựng
canadian	người canada
cancel	hủy bỏ, xóa bỏ
cancer	bệnh ung thư
candidate	người ứng cử, thí sinh, người dự thi
candle	nến
candy	kẹo
cannot	không thể
canvas	tranh sơn dầu
cap	mũ lưỡi trai, mũ vải
capability	khả năng
capable	có tài, có năng lực, có khả năng, cả gan
capacity	năng lực, khả năng tiếp thu, năng suất
capital	thủ đô, tiền vốn, chủ yếu, chính yếu, cơ bản
captain	người cầm đầu, người chỉ huy, thủ lĩnh
capture	bắt giữ, bắt, sự bắt giữ, sự bị bắt
car	xe hơi
carbohydrate	carbohydrate
carbon	carbon
card	thẻ, thiếp
cardboard	bìa cứng, các tông
care	sự chăm sóc, chăm nom, chăm sóc
career	nghề nghiệp, sự nghiệp
careful	cẩn thận, cẩn trọng, biết giữ gìn
carefully	cẩn thận, chu đáo
careless	sơ suất, cầu thả
cargo	hàng hóa
carpet	tấm thảm, thảm
carrier	vận chuyển
carrot	củ cà rốt
carry	mang, vác, khuân chở
cart	xe đẩy
cartoon	hoạt hình
carve	khắc chạm
case	vỏ, ngăn, túi
cash	tiền, tiền mặt
casino	casino
cast	quăng, ném, thả, đánh gục, sự quăng, sự ném
castle	thành trì, thành quách
casual	giản dị
casualty	tai nạn
cat	con mèo
catalog	mục lục
catch	bắt lấy, nắm lấy, tóm lấy, chộp lấy
category	hạng, loại, phạm trù
catholic	công giáo
cattle	gia súc
cause	nguyên nhân, nguyên do, gây ra, gây nên
cave	hang
cease	dừng, ngừng, ngớt, thôi, hết, tạnh
ceiling	trần nhà
celebrate	kỷ niệm, làm lễ kỷ niệm, tán dương, ca tụng
celebration	sự kỷ niệm, lễ kỷ niệm, sự tán dương, sự ca tụng
celebrity	người nổi tiếng
cell	ô, ngăn
cellphone	điện thoại di động
cemetery	nghĩa trang
cent	đồng xu
center	trung tâm
centimetre	xen ti met
central	trung tâm, ở giữa, trung ương
centre	điểm giữa, trung tâm, trung ương
century	thế kỷ
ceo	CEO
ceremony	nghi thức, nghi lễ
certain	chắc chắn
certainly	chắc chắn, nhất định
certificate	giấy chứng nhận, bằng, chứng chỉ
chain	dây, xích, xính lại, trói lại
chair	ghế
chairman	chủ tịch
chairman, chairwoman	chủ tịch, chủ tọa
challenge	sự thử thách, sự thách thức, thách thức, thử thách
chamber	buồng, phòng, buồng ngủ
champion	quán quân
championship	chức vô địch
chance	sự may mắn
change	thay đổi, sự thay đổi, sự biến đổi
changing	thay đổi
channel	kênh , eo biển
chaos	hỗn loạn
chapter	chương
character	tính cách, đặc tính, nhân vật
characteristic	riêng, riêng biệt, đặc trưng, đặc tính, đặc điểm
characterize	đặc trưng
charge	nhiệm vụ, bổn phận, trách nhiệm, giao nhiệm vụ, giao việc
charity	lòng từ thiện, lòng nhân đức, sự bố thí
charm	quyến rũ
chart	đồ thị, biểu đồ, vẽ đồ thị, lập biểu đồ
charter	điều lệ
chase	săn bắt, sự săn bắt
chat	nói chuyện, tán gẫu, chuyện phiếm, chuyện gẫu
cheap	rẻ
cheaply	rẻ, rẻ tiền
cheat	lừa, lừa đảo, trò lừa đảo, trò gian lận
check	kiểm tra, sự kiểm tra
cheek	má
cheer	vui lên
cheerful	vui mừng, phấn khởi, hồ hởi
cheerfully	vui vẻ, phấn khởi
cheese	pho mát
chef	đầu bếp
chemical	thuộc hóa học, chất hóa học, hóa chất
chemist	nhà hóa học
chemistry	hóa học
chemist’s	hóa học, môn hóa học, ngành hóa học
cheque	séc
chest	tủ, rương, hòm
chew	nhai, ngẫm nghĩ
chicken	gà, gà con, thịt gà
chief	trọng yếu, chính yếu, thủ lĩnh, lãnh tụ, người đứng đầu, xếp
child	đứa bé, đứa trẻ
childhood	thời thơ ấu
chill	làm lạnh
chin	cằm
chinese	trung quốc
chip	vỏ bào, mảnh vỡ, chỗ sứt, mẻ
chocolate	sô cô la
choice	sự lựa chọn
cholesterol	cholesterol
choose	chọn, lựa chọn
chop	chặt, đốn, chẻ
christian	christian
christianity	cơ đốc giáo
christmas	giáng sinh
chronic	mãn tính
chunk	mảnh
church	nhà thờ
chỉ huycomment	lời bình luận, lời chú giải, bình luận, phê bình, chú thích,
cigarette	điếu thuốc lá
circle	đường tròn, hình tròn
circuit	mạch
circumstance	hoàn cảnh, trường hợp, tình huống
cite	trích dẫn
citizen	người thành thị
citizenship	quyền công dân
city	thành phố
civic	công dân
civil	công dân
civilian	dân thường
civilization	nền văn minh
claim	đòi hỏi, yêu sách, sự đòi hỏi, sự yêu sách, sự thỉnh cầu
clap	vỗ, vỗ tay, tiếng nổ, tiếng vỗ tay
class	lớp học
classic	cổ điển, kinh điển
classical	cổ điển
classify	phân loại
classroom	lớp học, phòng học
clay	đất sét
clean	sạch, sạch sẽ,
clear	trong sáng
clearly	rõ ràng, sáng sủa
clerk	thư ký, linh mục, mục sư
clever	lanh lợi, thông minh. tài giỏi, khéo léo
click	làm thành tiếng lách cách, tiếng lách cách, cú nhắp
client	khách hàng
cliff	vách đá
climate	khí hậu, thời tiết
climb	leo, trèo
climbing	sự leo trèo
cling	bám lấy
clinic	phòng khám bệnh
clinical	lâm sàng
clip	kẹp
clock	đồng hồ
close	đóng kín, chật chội, che đậy
closed	bảo thủ, không cởi mở, khép kín
closely	chặt chẽ, kỹ lưỡng, tỉ mỉ
closer	gần hơn
closest	gần nhất
closet	buồng, phòng để đồ, phòng kho
cloth	vải, khăn trải bàn, áo thầy tu
clothes	quần áo
clothing	quần áo, y phục
cloud	mây, đám mây
club	câu lạc bộ, gậy, dùi cui
clue	manh mối
cluster	cụm
coach	huấn luyện viên
coal	than đá
coalition	liên minh
coast	sự lao dốc, bờ biển
coastal	duyên hải
coat	áo choàng
cocaine	cocaine
code	mật mã, luật, điều lệ
coffee	cà phê
cognitive	nhận thức
coin	tiền kim loại
cold	lạnh, sự lạnh lẽo, lạnh nhạt
coldly	lạnh nhạt, hờ hững, vô tâm
collaboration	hợp tác
collapse	đổ, sụp đổ, sự đổ nát, sự sụp đổ
collar	cổ áo
colleague	bạn đồng nghiệp
collect	sưu tập, tập trung lại
collection	sự sưu tập, sự tụ họp
collective	tập thể
collector	người thu gom
college	trường cao đẳng, trường đại học
colonial	thuộc địa
colony	thuộc địa
color	màu
colorful	Đầy màu sắc
colour	màu sắc, tô màu
coloured	mang màu sắc, có màu sắc
column	cột , mục
columnist	nhà bình luận viên
combat	chống lại
combination	sự kết hợp, sự phối hợp
combine	kết hợp, phối hợp
combined	kết hợp
come	đến, tới, đi đến, đi tới
comedy	hài kịch
comfort	sự an ủi, khuyên giải, lời động viên, sự an nhàn, dỗ dành, an
comfortable	thoải mái, tiện nghi, đầy đủ
comfortably	dễ chịu, thoải mái, tiện nghi, ấm cúng
coming	đang đến
command	ra lệnh, chỉ huy, lệnh, mệnh lệnh, quyền ra lệnh, quyền
commander	chỉ huy
comment	bình luận
commercial	buôn bán, thương mại
commission	hội đồng, ủy ban, sự ủy nhiệm, sự ủy thác, ủy nhiệm, ủy
commissioner	ủy viên
commit	giao, gửi, ủy nhiệm, ủy thác, tống giam, bỏ tù
commitment	sự phạm tội, sự tận tụy, tận tâm
committee	ủy ban
commodity	hàng hóa
common	công, công cộng, thông thường, phổ biến
commonly	thông thường, bình thường
communicate	truyền, truyền đạt, giao thiệp, liên lạc
communication	sự giao tiếp, liên lạc, sự truyền đạt, truyền tin
community	dân chúng, nhân dân
companion	đồng hành
company	công ty
comparable	so sánh
compare	so sánh, đối chiếu
comparison	sự so sánh
compel	bắt buộc
compelling	thuyết phục
compensation	đền bù
compete	đua tranh, ganh đua, cạnh tranh
competition	sự cạnh tranh, cuộc thi, cuộc thi đấu
competitive	cạnh tranh, đua tranh
competitor	đối thủ
complain	phàn nàn, kêu ca
complaint	lời than phiền, than thở, sự khiếu nại, đơn kiện
complete	hoàn thành, xong,
completely	hoàn thành, đầy đủ, trọn vẹn
complex	phức tạp, rắc rối
complexity	phức tạp
compliance	sự tuân thủ
complicate	làm phức tạp, rắc rối
complicated	phức tạp, rắc rối
comply	tuân theo
component	thành phần
compose	soạn, biên soạn
composition	thành phần
compound	hợp chất
comprehensive	toàn diện
comprise	bao gồm
compromise	thỏa hiệp
computer	máy tính
concede	công nhận
conceive	thụ thai
concentrate	tập trung
concentration	sự tập trung, nơi tập trung
concept	khái niệm
conception	quan niệm
concern	liên quan, dính líu tới, sự liên quan, sự dính líu tới
concerned	có liên quan, có dính líu
concerning	bâng khuâng, ái ngại
concert	buổi hòa nhạc
conclude	kết luận, kết thúc, chấm dứt
conclusion	sự kết thúc, sự kết luận, phần kết luận
concrete	bằng bê tông, bê tông
condemn	lên án
condition	điều kiện, tình cảnh, tình thế
conduct	điều khiển, chỉ đạo, chỉ huy, sự điều khiển, chỉ
conference	hội nghị, sự bàn bạc
confess	xưng
confession	lời thú tội
confidence	lòng tin tưởng, sự tin cậy
confident	tin tưởng, tin cậy, tự tin
confidently	tự tin
confine	giam giữ, hạn chế
confined	hạn chế, giới hạn
confirm	xác nhận, chứng thực
conflict	xung đột, va chạm, sự xung đột, sự va chạm
confront	đối mặt, đối diện, đối chiếu
confrontation	đối đầu
confuse	nhầm lẫn
confused	bối rối, lúng túng, ngượng
confusing	khó hiểu, gây bối rối
confusion	sự lộn xộn, sự rối loạn
congratulations	sự chúc mừng, khen ngợi, lời chúc mừng, khen
congress	đại hội, hội nghị, quốc hội
congressional	quốc hội
connect	kết nối, nối
connection	sự kết nối, sự giao kết
conscience	lương tâm
conscious	tỉnh táo, có ý thức, biết rõ
consciousness	ý thức
consecutive	liên tiếp
consensus	sự đồng thuận
consent	bằng lòng
consequence	kết quả, hậu quả
consequently	hậu quả là
conservation	bảo tồn
conservative	thận trọng, dè dặt, bảo thủ
consider	cân nhắc, xem xét, để ý, quan tâm, lưu ý đến
considerable	lớn lao, to tát, đáng kể
considerably	đáng kể, lớn lao, nhiều
consideration	sự cân nhắc, sự xem xét, sự để ý, sự quan tâm
consist	bao gồm
consist of	gồm có
consistent	thích hợp
consistently	nhất quán
conspiracy	âm mưu
constant	kiên trì, bền lòng
constantly	kiên định
constitute	cấu tạo
constitution	hiến pháp
constitutional	hiến pháp
constraint	hạn chế
construct	xây dựng
construction	sự xây dựng
consult	tra cứu, tham khảo, thăm dò, hỏi ý kiến
consultant	tư vấn
consume	tiêu dùng
consumer	người tiêu dùng
consumption	tiêu dùng
contact	sự liên lạc, sự giao thiệp, tiếp xúc
contain	bao hàm, chứa đựng, bao gồm
container	cái đựng, chứa, công te nơ
contemplate	thưởng ngoạn
contemporary	đương thời, đương đại
contend	đấu tranh
content	nội dung, sự hài lòng
contest	cuộc thi, trận đấu, cuộc tranh luận, cuộc chiến đấu, chiến tranh
context	văn cảnh, khung cảnh, phạm vi
continent	lục địa, đại lục
continue	tiếp tục, làm tiếp
continued	tiếp tục
continuing	tiếp tục
continuous	liên tục, liên tiếp
continuously	liên tục, liên tiếp
contract	hợp đồng, sự ký hợp đồng, ký kết
contractor	nhà thầu
contrast	sự tương phản, làm tương phản, làm trái
contrasting	tương phản
contribute	đóng góp, ghóp phần
contribution	sự đóng góp, sự góp phần
contributor	người đóng góp
control	điều khiển
controlled	được điều khiển, được kiểm tra
controversial	gây tranh cãi
controversy	tranh cãi
convenience	tiện
convenient	tiện lợi, thuận lợi, thích hợp
convention	hội nghị, hiệp định, quy ước
conventional	quy ước
conversation	cuộc đàm thoại, cuộc trò chuyện
conversion	chuyển đổi
convert	đổi, biến đổi
convey	chuyên chở
convict	tù nhân
conviction	lòng tin chắc, sự kết án, phán quyết
convince	làm cho tin, thuyết phục, làm cho nhận thức thấy
convinced	thuyết phục
cook	nấu ăn, người nấu ăn
cooker	lò, bếp, nồi nấu
cookie	bánh quy
cooking	sự nấu ăn, cách nấu ăn
cool	mát mẻ, điềm tĩnh, làm mát,
cooperate	hợp tác
cooperation	hợp tác
cooperative	hợp tác xã
coordinate	danh từ  tọa độ
coordinator	điều phối viên
cop	cảnh sát
cope	đối phó, đương đầu
copy	bản sao, bản chép lại, sự sao chép, sao chép, bắt chước
cord	dây
core	nòng cốt, hạt nhân, đáy lòng
corn	ngô
corner	góc
corporate	công ty
corporation	tập đoàn
correct	đúng, chính xác, sửa, sửa chữa
correctly	đúng, chính xác
correlation	tương quan
correspondent	phóng viên
corridor	hành lang
corruption	tham nhũng
cost	giá, chi phí, trả giá, phải trả
costly	tốn kém
costume	trang phục
cottage	nhà tranh
cotton	bông, chỉ, sợi
couch	đi văng
cough	ho, sự ho, tiếng hoa
coughing	ho
could	có thể, có khả năng
could modal	có thể
council	hội đồng
counsel	lời khuyên
counseling	tư vấn
counselor	cố vấn
count	đếm, tính
counter	quầy hàng, quầy thu tiền, máy đếm
counterpart	đối tác
country	nước, quốc gia, đất nước
countryside	miền quê, miền nông thôn
county	hạt, tỉnh
coup	cuộc đảo chính
couple	đôi, cặp, đôi vợ chồng, cặp nam nữ
courage	sự can đảm, sự dũng cảm, dũng khí
course	tiến trình, quá trình diễn tiến, sân chạy đua
court	sân, sân , tòa án, quan tòa, phiên tòa
courtroom	phòng xử án
cousin	anh em họ
cover	bao bọc, che phủ, vỏ, vỏ bọc
coverage	phủ sóng
covered	có mái che, kín đáo
covering	sự bao bọc, sự che phủ, cái bao, bọc
cow	con bò cái
crack	cừ, xuất sắc, làm nứt, làm vỡ, nứt nẻ, rạn nứt
cracked	rạn, nứt
craft	nghề, nghề thủ công
crash	vải thô, sự rơi , sự phá sản, sụp đổ, phá tan tành, phá vụn
crawl	thu thập thông tin
crazy	điên, mất trí
cream	kem
create	sáng tạo, tạo nên
creation	sự sáng tạo
creative	sáng tạo
creativity	sáng tạo
creature	sinh vật, loài vật
credibility	uy tín
credit	sự tin, lòng tin, danh tiếng, tiền gửi ngân hàng
credit card	thẻ tín dụng
crew	phi hành đoàn
crime	tội, tội ác, tội phạm
criminal	có tội, phạm tội, kẻ phạm tội, tội phạm
crisis	sự khủng hoảng, cơn khủng hoảng
crisp	giòn
criteria	tiêu chuẩn
criterion	tiêu chuẩn
critic	nhà phê bình
critical	phê bình, phê phán, khó tính
criticism	sự phê bình, sự phê phán, lời phê bình, lời phê phán
criticize	phê bình, phê phán, chỉ trích
crop	vụ mùa
cross	cây thánh giá, nỗi thống khổ, sự băng qua, băng qua, vượt qua
crowd	đám đông
crowded	đông đúc
crown	vương miện, vua, ngai vàng, đỉnh cao nhất
crucial	quyết định, cốt yếu, chủ yếu
cruel	độc ác, dữ tợn, tàn nhẫn
cruise	du lịch
crush	ép, vắt, đè nát, đè bẹp
cry	khóc, kêu la, sự khóc, tiếng khóc, sự kêu la
crystal	pha lê
cuban	cuba
cue	gợi ý
cultural	văn hóa
culture	văn hóa, sự mở mang, sự giáo dục
cup	tách, chén
cupboard	1 loại tủ có ngăn
curb	kiềm chế, nén lại, hạn chế
cure	chữa trị, điều trị, cách chữa bệnh, cách điều trị, thuốc
curiosity	sự tò mò
curious	ham muốn, tò mò, lạ lùng
curiously	tò mò, hiếu kỳ, lạ kỳ
curl	quăn, xoắn, uốn quăn, làm xoắn, sự uốn quăn
curly	quăn, xoắn
currency	tiền tệ
current	hiện hành, phổ biến, hiện nay, dòng
currently	hiện thời, hiện nay
curriculum	chương trình giáo dục
curtain	màn
curve	đường cong, đường vòng, cong, uốn cong, bẻ cong
curved	cong
custody	quyền nuôi con
custom	phong tục, tục lệ, thói quen, tập quán
customer	khách hàng
customs	thuế nhập khẩu, hải quan
cut	cắt, chặt, sự cắt
cute	dễ thương
cycle	chu kỳ, chu trình, vòng, quay vòng theo chu kỳ, đi xe đạp
cycling	sự đi xe đạp
dad	bố, cha
daily	hàng ngày
dam	con đập
damage	mối hạn, điều hại, sự thiệt hại, làm hư hại, làm hỏng, gây thiệt hại
damn	chỉ trích
damp	ẩm, ẩm ướt, ẩm thấp
dance	sự nhảy múa, sự khiêu vũ, nhảy múa, khiêu vũ
dancer	diễn viên múa, người nhảy múa
dancing	sự nhảy múa, sự khiêu vũ
danger	sự nguy hiểm, mối hiểm nghèo, nguy cơ, mối đe dọa
dangerous	nguy hiểm
dare	dám, dám đương đầu với, thách
dark	tối, tối tăm, bóng tối, ám muội
darkness	bóng tối
data	số liệu, dữ liệu
database	cơ sở dữ liệu
date	ngày, kỳ, kỳ hạn, thời kỳ, thời đại, đề ngày tháng, ghi niên hiệu
daughter	con gái
dawn	bình minh
day	ngày, ban ngày
dead	chết, tắt
deadline	hạn chót
deadly	chết người
deaf	điếc, làm thinh, làm ngơ
deal	phân phát, phân phối, sự giao dịch, thỏa thuận mua bán
deal with	giải quyết
dealer	người buôn bán
dear	thân, thân yêu, thân mến, kính thưa, thưa
death	sự chết, cái chết
debate	cuộc tranh luận, cuộc tranh cãi, tranh luận, bàn cãi
debris	mảnh vụn
debt	nợ
debut	ra mắt
decade	thập kỷ, bộ mười, nhóm mười
decay	tình trạng suy tàn, suy sụp, tình trạng đổ nát
december	tháng mười hai, tháng chạp
decent	phong nha
decide	quyết định, giải quyết, phân xử
decision	sự quyết định, sự giải quyết, sự phân xử
deck	boong
declare	tuyên bố, công bố
decline	sự suy tàn, sự suy sụp, suy sụp, suy tàn
decorate	trang hoàng, trang trí
decoration	sự trang hoàng, đồ trang hoàng, trang trí
decorative	để trang hoàng, để trang trí, để làm cảnh
decrease	giảm bớt, làm suy giảm, sự giảm đi, sự giảm sút
dedicate	dâng hiến
deem	thấy
deep	sâu, khó lường, bí ẩn
deeply	sâu, sâu xa, sâu sắc
deer	con nai
defeat	đánh thắng, đánh bại, sự thất bại
defence	cái để bảo vệ, vật để chống đỡ, sự che chở
defend	che chở, bảo vệ, bào chữa
defendant	bị cáo
defender	hậu vệ
defense	phòng thủ
defensive	phòng ngự
deficit	thâm hụt
define	định nghĩa
definite	xác định, định rõ, rõ ràng
definitely	rạch ròi, dứt khoát
definition	sự định nghĩa, lời định nghĩa
degree	mức độ, trình độ, bằng cấp, độ
delay	sự chậm trễ, sự trì hoãn, sự cản trở, làm chậm trễ
deliberate	thận trọng, có tính toán, chủ tâm, có suy nghĩ cân nhắc
deliberately	thận trọng, có suy nghĩ cân nhắc
delicate	thanh nhã, thanh tú, tế nhị, khó xử
delight	sự vui thích, sự vui sướng, điều thích thú, làm vui thích, làm say
delighted	vui mừng, hài lòng
deliver	cứu khỏi, thoát khỏi, bày tỏ, giãi bày
delivery	sự phân phát, sự phân phối, sự giao hàng, sự bày tỏ, phát biếu
demand	sự đòi hỏi, sự yêu cầu, đòi hỏi, yêu cầu
democracy	dân chủ
democrat	dân chủ
democratic	dân chủ
demographic	nhân khẩu học
demonstrate	chứng minh, giải thích, bày tỏ, biểu lộ
demonstration	trình diễn
denial	từ chối
dense	dày đặc
density	tỉ trọng
dentist	nha sĩ
deny	từ chối, phản đối, phủ nhận
depart	khởi hành
department	cục, sở, ty, ban, khoa, gian hàng, khu bày hàng
departure	sự rời khỏi, sự đi, sự khởi hành
depend	phụ thuộc, tùy thuộc, dựa vào, ỷ vào, trông mong vào
dependent	phụ thuộc
depending	tùy
depict	miêu tả
deploy	triển khai
deposit	vật gửi, tiền gửi, tiền đặt cọc, gửi, đặt cọc
depress	làm chán nản, làm phiền muộn, làm suy giảm
depressed	chán nản, thất vọng, phiền muộn, suy yếu, đình trệ
depressing	làm chán nản làm thát vọng, làm trì trệ
depression	phiền muộn
depth	chiều sâu, độ dày
deputy	phó
derive	nhận được từ, lấy được từ, xuất phát từ, bắt nguồn, chuyển hóa từ
descend	hạ xuống
describe	diễn tả, miêu tả, mô tả
description	sự mô tả, sự tả, sự miêu tả
desert	sa mạc, công lao, giá trị, rời bỏ, bỏ trốn
deserted	hoang vắng, không người ở
deserve	đáng, xứng đáng
design	sự thiết kế, kế hoạch, đề cương. phác thảo, phác họa, thiết kế
designer	nhà thiết kế
desire	ước muốn, thèm muốn, ao ước
desk	bàn
desperate	liều mạng, liều lĩnh, tuyệt vọng
desperately	liều lĩnh, liều mạng
despite	dù, mặc dù, bất chấp
dessert	món tráng miệng
destination	nơi đến
destroy	phá, phá hoại, phá huỷ, tiêu diệt, triệt phá
destruction	sự phá hoại, sự phá hủy, sự tiêu diệt
detail	chi tiết
detailed	cặn kẽ, tỉ mỉ, nhiều chi tiết
detect	phát hiện
detective	thám tử
determination	sự xác định, sự định rõ, sự quyết định
determine	xác định, định rõ, quyết định
determined	đã được xác định, đã được xác định rõ
devastating	tàn phá
develop	phát triển, mở rộng, trình bày, bày tỏ
developer	nhà phát triển
developing	phát triển
development	sự phát triển, sự trình bày, sự bày tỏ
developmental	phát triển
device	kế sách, thiết bị, dụng cụ, máy móc
devil	ác quỷ
devote	hiến dâng, dành hết cho
devoted	hiến cho, dâng cho, dành cho, hết lòng, nhiệt tình
diabetes	bệnh tiểu đường
diagnose	chẩn đoán
diagnosis	chẩn đoán
diagram	biểu đồ
dialogue	đối thoại
diamond	kim cương
diary	sổ nhật ký, lịch ghi nhớ
dictate	điều khiển
dictionary	từ điển
die	chết, từ trần, hy sinh
diet	chế độ ăn uống, chế độ ăn kiêng
differ	khác nhau
difference	sự khác nhau
different	khác, khác biệt, khác nhau
differently	khác, khác biệt, khác nhau
difficult	khó, khó khăn, gay go
difficulty	sự khó khăn, nỗi khó khăn, điều cản trở
dig	đào bới, xới
digital	kỹ thuật số
dignity	phẩm giá
dilemma	tình trạng khó xử
dimension	kích thước
diminish	suy giảm
dining	ăn uống
dinner	bữa trưa, chiều
dip	nhúng
diplomat	nhà ngoại giao
diplomatic	ngoại giao
direct	trực tiếp, thẳng, thẳng thắn, gửi, viết cho ai, điều khiển
direction	sự điều khiển, sự chỉ huy
directly	trực tiếp, thẳng
director	giám đốc, người điều khiển, chỉ huy
dirt	đồ bẩn thỉu, đồ dơ bẩn, vật rác rưởi
dirty	bẩn thỉu, dơ bẩn
disability	khuyết tật
disabled	bất lực, không có khă năng
disadvantage	sự bất lợi, sự thiệt hại
disagree	bất đồng, không đồng ý, khác, không giống, không hợp
disagreement	sự bất đồng, sự không đồng ý, sự khác nhau
disappear	biến mất, biến đi
disappoint	không làm thỏa ước nguyện, ý mong đợi, thất ước, làm thất
disappointed	thất vọng
disappointing	làm chán ngán, làm thất vọng
disappointment	sự chán ngán, sự thất vọng
disapproval	sự phản đổi, sự không tán thành
disapprove	không tán thành, phản đối, chê
disapproving	phản đối
disaster	tai họa, thảm họa
disc	đĩa
discipline	kỷ luật
disclose	tiết lộ
discount	sự bớt giá, sự chiết khấu, tiền bớt, chiết khấu
discourage	gây chán nản cho
discourse	đàm luận
discover	khám phá, phát hiện ra, nhận ra
discovery	sự khám phá, sự tìm ra, sự phát hiện ra
discrimination	kỳ thị
discuss	thảo luận, tranh luận
discussion	sự thảo luận, sự tranh luận
disease	căn bệnh, bệnh tật
disgust	làm ghê tởm, làm kinh tởm, làm phẫn nộ
disgusted	chán ghét, phẫn nộ
disgusting	làm ghê tởm, kinh tởm
dish	đĩa
dishonest	bất lương, không thành thật
dishonestly	bất lương, không lương thiện
disk	đĩa, đĩa hát
dislike	sự không ưa, không thích, sự ghét
dismiss	giải tán
disorder	rối loạn
display	bày tỏ, phô trương, trưng bày, sự bày ra, phô bày, trưng bày
dispute	tranh chấp
dissolve	tan rã, phân hủy, giải tán
distance	khoảng cách, tầm xa
distant	xa xôi
distinct	khác biệt
distinction	phân biệt
distinctive	đặc biệt
distinguish	phân biệt, nhận ra, nghe ra
distract	làm mất tập trung
distribute	phân bổ, phân phối, sắp xếp, phân loại
distribution	sự phân bổ, sự phân phối, phân phát, sự sắp xếp
district	huyện, quận
disturb	làm mất yên tĩnh, làm náo động, quấy rầy
disturbing	xáo trộn
diverse	phong phú
diversity	sự đa dạng
divide	chia, chia ra, phân ra
divine	thần thánh
division	sự chia, sự phân chia, sự phân loại
divorce	đã ly dị
dna	dna
do	làm
dock	bến tàu
doctor	bác sĩ y khoa, tiến sĩ
doctrine	học thuyết
document	văn kiện, tài liệu, tư liệu
documentary	phim tài liệu
dog	chó
doll	búp bê
dollar	đô la mỹ
domain	miền
domestic	vật nuôi trong nhà,  nội trợ, quốc nội
dominant	có ưu thế
dominate	chiếm ưu thế, có ảnh hưởng, chi phối, kiềm chế
donate	hiến tặng
donation	quyên góp
donor	nhà tài trợ
door	cửa, cửa ra vào
doorway	lối vào
dose	liều
dot	chấm nhỏ, điểm, của hồi môn
double	đôi, hai, kép, cái gấp đôi, lượng gấp đôi, làm gấp đôi
doubt	sự nghi ngờ, sự ngờ vực, nghi ngờ, ngờ vực
dough	bột
down	xuống
downstairs	ở dưới nhà, ở tầng dưới, xống gác, tầng dưới
downtown	trung tâm thành phố
downward	xuống, đi xuống
downwards	xuống, đi xuống
dozen	tá
draft	bản phác thảo, sơ đồ thiết kế, phác thảo, thiết kế
drag	lôi kéo, kéo lê
drain	ráo nước
drama	kịch, tuồng
dramatic	như kịch, như đóng kịch, thích hợp với sân khấu
dramatically	đột ngột
draw	vẽ, kéo
drawer	người vẽ, người kéo
drawing	bản vẽ, bức vẽ, sự kéo
dream	giấc mơ, mơ
dress	quần áo, mặc , ăn mặc
dried	khô
drift	trôi dạt
drill	máy khoan
drink	đồ uống, uống
drinking	uống
drive	lái , đua xe, cuộc đua xe
driver	người lái xe
driveway	đường lái xe
driving	sự lái xe, cuộc đua xe
drop	chảy nhỏ giọt, rơi, rớt, giọt
drown	chết chìm
drug	thuốc, dược phẩm, ma túy
drugstore	hiệu thuốc, cửa hàng dược phẩm
drum	cái trống, tiếng trống
drunk	say rượu
dry	khô, cạn, làm khô, sấy khô
duck	con vịt
due	đến kỳ hạn , xứng đáng, thích đáng
due to	vì, do, tại, nhờ có
dull	chậm hiểu, ngu đần
dumb	ngớ ngẩn
dump	đổ rác, đống rác, nơi đổ rác
during	trong lúc, trong thời gian
dust	bụi, rác, rắc , quét bụi, phủi bụi
dutch	người hà lan
duty	sự tôn kính, kính trọng, bồn phận, trách nhiệm
dying	sự chết
dynamic	năng động
dynamics	động lực học
e-mail	e-mail
each	mỗi
each other	nhau, lẫn nhau
eager	hăng hái
ear	tai
early	sớm
earn	kiếm
earnings	thu nhập
earth	đất, trái đất
earthquake	động đất
ease	sự thanh thản, sự thoải mái, làm thanh thản, làm yên tâm, làm dễ chịu
easily	dễ dàng
east	hướng đông, phía đông,  đông, ở phía đông
eastern	đông
easy	dễ dàng, dễ tính, ung dung
eat	ăn
eating	Ăn
echo	echo
ecological	sinh thái
economic	kinh tế
economically	kinh tế
economics	kinh tế học
economist	nhà kinh tế học
economy	sự tiết kiệm, sự quản lý kinh tế
ecosystem	hệ sinh thái
edge	lưỡi, cạnh sắc
edit	chỉnh sửa
edition	nhà xuất bản, sự xuất bản
editor	người thu thập và xuất bản, chủ bút
educate	giáo dục, cho ăn học, rèn luyện
educated	được giáo dục, được đào tạo
education	sự giáo dục, sự rèn luyện
educational	giáo dục
educator	nhà giáo dục
effect	hiệu ứng, hiệu quả, kết quả
effective	có kết quả, có hiệu lực
effectively	có kết quả, có hiệu lực
effectiveness	hiệu quả
efficiency	hiệu quả
efficient	có hiệu lực, có hiệu quả
efficiently	có hiệu quả, hiệu nghiệm
effort	sự cố gắng, sự nỗ lực
egg	trứng
ego	tự ngã
eight	tám
eighth	thứ tám
either	mỗi, một, cũng phải thế
elaborate	kỹ lưỡng
elbow	khuỷu tay
elder	đàn anh
elderly	có tuổi, cao tuổi
elect	bầu, quyết định
election	sự bầu cử, cuộc tuyển cử
electric	điện, có điện, phát điện
electrical	điện
electricity	điện, điện lực, điện lực học
electronic	điện tử
electronics	thiết bị điện tử
elegant	thanh lịch, tao nhã
element	yếu tôd, nguyên tố
elementary	tiểu học
elephant	con voi
elevator	thang máy
eleven	mười một
eligible	hội đủ điều kiện
eliminate	loại bỏ
elite	ưu tú
else	khác, nữa, nếu không
elsewhere	ở một nơi nào khác
email	thư điện tử, gửi thư điện tử
embarrass	lúng túng, làm ngượng nghịu, làm rắc rối, gây khó khăn
embarrassed	lúng túng, bối rối, ngượng, mang nợ
embarrassing	làm lúng túng, ngăn trở
embarrassment	sự lúng túng, sự bối rối
embrace	ôm hôn
emerge	nổi lên, hiện ra, nổi bật lên
emergency	tình trạng khẩn cấp
emerging	mới nổi
emission	khí thải
emotion	xự xúc động, sự cảm động, mối xác cảm
emotional	cảm động, xúc động, xúc cảm, dễ cảm động, dễ xúc cảm
emotionally	xúc động
emphasis	sự nhấn mạnh, tầm quan trọng
emphasize	nhấn mạnh, làm nổi bật
empire	đế chế, đế quốc
employ	dùng, thuê ai làm gì
employee	người lao động, người làm công
employer	chủ, người sử dụng lao động
employment	sự thuê mướn
empty	trống, rỗng, đổ, dốc, uống, làm cạn
enable	làm cho có thể, có khả năng, cho phép ai làm gì
enact	ban hành
encounter	chạm chán, bắt gặp, sự chạm trán, sự bắt gặp
encourage	động viên, ủng hộ, giúp đỡ, làm can đảm, mạnh dạn
encouragement	niềm cổ vũ, động viên, khuyến khích, sự làm can đảm
encouraging	khuyến khích
end	giới hạn, sự kết thúc, kết thúc, chấm dứt
ending	sự kết thúc, sự chấm dứt, phần cuối, kết cục
endless	bất tận
endorse	chứng thực
endure	chịu đựng
enemy	kẻ thù, quân địch
energy	năng lượng, nghị lực, sinh lực
enforce	thi hành
enforcement	thực thi
engage	hứa hẹn, cam kết, đính ước
engaged	đã đính ước, đã hứa hôn, đã có người
engagement	hôn ước
engine	máy, động cơ
engineer	kỹ sư
engineering	nghề kỹ sư, công việc của kỹ sư
english	anh
enhance	nâng cao
enjoy	thưởng thức, thích thú cái gì, được hưởng, có được
enjoyable	thú vị, thích thú
enjoyment	sự thích thú, sự có được, được hưởng
enormous	to lớn, khổng lồ
enough	đủ
enquiry	sự điều tra, sự thẩm vấn
enroll	ghi danh
ensure	bảo đảm, chắc chắn
enter	đi vào, gia nhập
enterprise	doanh nghiệp
entertain	giải trí, tiếp đón, chiêu đãi
entertainer	người quản trò, người tiếp đãi, chiêu đãi
entertaining	giải trí
entertainment	sự giải trí, sự tiếp đãi, chiêu đãi
enthusiasm	sự hăng hái, sự nhiệt tình
enthusiastic	hăng hái, say mê, nhiệt tình
entire	toàn thể, toàn bộ
entirely	toàn vẹn, trọn vẹn, toàn bộ
entitle	cho tiêu đề, cho tên , cho quyền làm gì
entity	thực thể
entrance	sự đi vào, sự nhậm chức
entrepreneur	doanh nhân
entry	sự ghi vào sổ sách, sự đi vào, sự tiếp nhận
envelope	phong bì
environment	môi trường, hoàn cảnh xung quanh
environmental	thuộc về môi trường
envision	hình dung
epidemic	bệnh dịch
episode	tập phim
equal	ngang, bằng, người ngang hàng, ngang tài, sức, bằng, ngang
equality	bình đẳng
equally	bằng nhau, ngang bằng
equation	phương trình
equip	trang bị
equipment	trang, thiết bị
equity	công bằng
equivalent	tương đương, từ, vật tương đương
era	kỷ nguyên
error	lỗi, sự sai sót, sai lầm
escape	trốn thoát, thoát khỏi, sự trốn thoát, lỗi thoát
especially	đặc biệt là, nhất là
essay	bài tiểu luận
essence	bản chất
essential	bản chất, thực chất, cốt yếu, yếu tố cần thiết
essentially	về bản chất, về cơ bản
establish	lập, thành lập
establishment	thành lập
estate	tài sản, di sản, bất động sản
estimate	sự ước lượng, đánh giá, ước lượng, đánh giá
estimated	ước tính
etc	vân vân
ethical	đạo đức
ethics	đạo đức
ethnic	dân tộc
euro	đơn vị tiền tệ của liên minh châu âu
european	châu Âu
evaluate	đánh giá
evaluation	đánh giá
even	ngay cả, ngay, lại còn, bằng phẳng, điềm đạm, ngang bằng
evening	buổi chiều, tối
event	sự việc, sự kiện
eventually	cuối cùng
ever	từng, từ trước tới giờ
every	mỗi, mọi
everybody	mọi người
everyday	mỗi ngày
everyone	mọi người
everything	mọi vật, mọi thứ
everywhere	mọi nơi
evidence	điều hiển nhiên, điều rõ ràng
evident	hiển nhiên
evil	xấu, ác, điều xấu, điều ác, điều tai hại
evolution	sự phát triển
evolve	phát triển
ex- prefix	tiền tố chỉ bên ngoài
exact	chính xác, đúng
exactly	chính xác, đúng đắn
exaggerate	cường điệu, phóng đại
exaggerated	cường điệu, phòng đại
exam	viết tắt của examination
examination	sự thi cử, kỳ thi
examine	thẩm tra, khám xét, hỏi han
example	thí dụ, ví dụ
exceed	quá
excellent	xuất sắc, xuất chúng
except	trừ ra, không kể, trừ phi
exception	sự trừ ra, sự loại ra
excessive	quá đáng
exchange	trao đổi, sự trao đổi
excite	kích thích, kích động
excited	bị kích thích, bị kích động
excitement	sự kích thích, sự kích động
exciting	hứng thú, thú vị
exclude	ngăn chạn, loại trừ
excluding	ngoài ra, trừ ra
exclusive	độc quyền
exclusively	duy nhất
excuse	lời xin lỗi, bào chữa, xin lỗi, tha thứ, tha lỗi
execute	thi hành
execution	chấp hành
executive	sự thi hành, chấp hành,  sự thi hành, chấp hành
exempli gratia	trứng
exercise	bài tập, sự thi hành, sự thực hiện, làm, thi hành, thực hiện
exhaust	thoát ra
exhibit	trưng bày, triển lãm, vật trưng bày, vật triển lãm
exhibition	cuộc triển lãm, trưng bày
exist	tồn tại, sống
existence	sự tồn tại, sự sống
existing	hiện tại
exit	lỗi ra, sự đi ra, thoát ra
exotic	kỳ lạ
expand	mở rộng, phát triển, nở, giãn ra
expansion	sự bành trướng
expect	chờ đợi, mong ngóng, liệu trước
expectation	sự mong chờ, sự chờ đợi
expected	được chờ đợi, được hy vọng
expedition	thám hiểm
expense	chi phí
expensive	đắt
experience	kinh nghiệm, trải qua, nếm mùi
experienced	có kinh nghiệm, từng trải, giàu kinh nghiệm
experiment	cuộc thí nghiệm, thí nghiệm
experimental	thử nghiệm
expert	chuyên gia, chuyên môn, thành thạo
expertise	chuyên môn
explain	giải nghĩa, giải thích
explanation	sự giải nghĩa, giải thích
explicit	rõ ràng
explo	de  nổ tung
explode	đập tan , làm nổ, nổ
exploit	khai thác
exploration	thăm dò
explore	thăm dò, thám hiểm
explosion	sự nổ, sự phát triển ồ ạt
export	xuất khẩu, hàng xuất khẩu, sự xuất khẩu
expose	trưng bày, phơi bày
exposure	phơi bày
express	diễn tả, biểu lộ, bày tỏ, nhanh, tốc hành
expression	sự diễn tả, sự bày tỏ, biểu lộ, sự diễn đạt
extend	giơ, duỗi ra , dành cho, gửi lời
extended	mở rộng
extension	sự giơ, duỗi, sự kéo dài, sự dành cho, gửi lời
extensive	rộng rãi, bao quát
extent	quy mô, phạm vi
external	bên ngoài
extra	thêm, phụ, ngoại, thứ thêm, phụ
extraordinary	đặc biệt, lạ thường, khác thường
extreme	vô cùng, khắc nghiệt, quá khích, cực đoan, sự quá khích
extremely	vô cùng, cực độ
eye	mắt
eyebrow	lông mày
fabric	vải
face	mặt, thể diện, đương đầu, đối phó, đối mặt
facilitate	tạo điều kiện
facility	điều kiện dễ dàng, sự dễ dàng, thuận lợi
fact	việc, sự việc, sự kiện
factor	nhân tố
factory	nhà máy, xí nghiệp, xưởng
faculty	giảng viên
fade	phai màu
fail	sai, thất bại
failure	sự thất bại, người thất bại
faint	nhút nhát, yếu ớt
faintly	nhút nhát, yếu ớt
fair	hợp lý, công bằng, thuận lợi
fairly	hợp lý, công bằng
faith	sự tin tưởng, tin cậy, niềm tin, vật đảm bảo
faithful	trung thành, chung thủy, trung thực
faithfully	trung thành, chung thủy, trung thực
fall	rơi, ngã, sự rơi, ngã
fall asleep	ngủ thiếp đi
fall over	ngã lộn nhào, bị đổ
false	sai, nhầm, giả dối
fame	tên tuổi, danh tiếng
familiar	thân thiết, quen thộc
family	gia đình, thuộc gia đình
famous	người hâm mộ
fan	quạt
fancy	tưởng tượng, cho, nghĩ rằng, tưởng tượng
fantastic	tuyệt diệu
fantasy	tưởng tượng
far	xa
fare	giá vé
farm	trang trại
farmer	nông dân, người chủ trại
farming	công việc trồng trọt, đồng áng
fascinating	hấp dẫn
fashion	mốt, thời trang
fashionable	đúng mốt, hợp thời trang
fast	nhanh
fasten	buộc, trói
faster	nhanh hơn
fat	béo, béo bở, mỡ, chất béo
fatal	gây tử vong
fate	số phận
father	cha
fatigue	mệt mỏi
faucet	vòi
fault	sự thiết sót, sai sót
favor	ủng hộ
favorable	thuận lợi
favorite	yêu thích
favour	thiện ý, sự quý mến, sự đồng ý, sự chiếu cố
fear	sự sợ hãi, e sợ, sợ, lo ngại
feather	lông chim
feature	nét đặt biệt, điểm đặc trưng, mô tả nét đặc biệt, đặc trưng của...
february	tháng 2
federal	liên bang
fee	tiền thù lao, học phí
feed	cho ăn, nuôi
feedback	phản hồi
feel	cảm thấy
feel sick	buồn nôn
feeling	sự cảm thấy, cảm giác
fellow	anh chàng , đồng chí
female	thuộc giống cái, giống cái
feminist	nữ quyền sĩ
fence	hàng rào
festival	lễ hội, đại hội liên hoan
fetch	tìm về, đem về, làm bực mình, làm say mê, quyến rũ
fever	cơn sốt, bệnh sốt
few	ít,vài, một ít, một vài
fewer	ít hơn
fiber	chất xơ
fiction	viễn tưởng
field	cánh đồng, bãi chiến trường
fierce	khốc liệt
fifteen	mười lăm
fifth	thứ năm
fifty	năm mươi
fight	đấu tranh, chiến đấu, sự đấu tranh, cuộc chiến đấu
fighter	đấu sĩ
fighting	sự chiến đấu, sự đấu tranh
figure	hình dáng, nhân vật, hình dung, miêu tả
file	hồ sơ, tài liệu
fill	làm đấy, lấp kín
film	phim, được dựng thành phim
filter	lọc
final	cuối cùng, cuộc đấu chung kết
finally	cuối cùng, sau cùng
finance	tài chính, tài trợ, cấp vốn
financial	thuộc
find	tìm, tìm thấy
find out sth	khám phá, tìm ra
finding	phát hiện
fine	tốt, giỏi
finely	đẹp đẽ, tế nhị, cao thượng
finger	ngón tay
finish	kết thúc, hoàn thành, sự kết thúc, phần cuối
finished	hoàn tất, hoàn thành
fire	lửa, đốt cháy
firm	hãng, công ty, chắc, kiên quyết, vũng vàng, mạnh mẽ
firmly	vững chắc, kiên quyết
first	Đầu tiên
first det	thứ nhất, đầu tiên, trước hết, người, vật đầu tiên, thứ nhất
fiscal	tài chính
fish	cá, món cá, câu cá, bắt cá
fisherman	ngư dân
fishing	sự câu cá, sự đánh cá
fist	nắm tay
fit	hợp, vừa, thích hợp, xứng đáng
fitness	sự tập thể dục
five	số năm
fix	đóng, gắn, lắp, sửa chữa, sửa sang
fixed	đã sửa
flag	quốc kỳ
flame	ngọn lửa
flash	loé sáng, vụt sáng, ánh sáng lóe lên, đèn nháy
flat	bằng phẳng, bẹt, nhẵn, dãy phòng, căn phòng, mặt phẳng
flavor	hương vị
flavour	vị, mùi, cho gia vị, làm tăng thêm mùi vị
flee	chạy trốn
fleet	hạm đội
flesh	thịt
flexibility	mềm dẻo
flexible	linh hoạt
flight	sự bỏ chạy, rút chạy, sự bay, chuyến bay
flip	lật
float	lụt, lũ lụtl, tràn đầy, tràn ngập
flood	lũ
floor	sàn, tầng
flour	bột, bột mỳ
flow	sự chảy, chảy
flower	hoa, bông, đóa, cây hoa
flu	bệnh cúm
fluid	chất lỏng
fly	bay, sự bay, quãng đường bay
flying	biết bay, sự bay, chuyến bay
focus	tập trung, trung tâm, trọng tâm
fog	sương mù
fold	gấp, vén, xắn, nếp gấp
folding	gấp lại được
folk	dân gian
follow	đi theo sau, theo, tiếp theo
following	tiếp theo, theo sau, sau đây, sau, tiếp theo
food	đồ ăn, thức, món ăn
fool	ngu xuẩn
foot	chân, bàn chân
football	bóng đá
for	cho, dành cho...
for instance	ví dụ chẳng hạn
forbid	ngăn cấm
force	sức mạnh, ép buộc, cưỡng ép
forecast	sự dự đoán, dự báo, dự đoán, dự báo
forehead	trán
foreign	nước ngoài, từ nước ngoài, ở nước ngoài
foreigner	người nước ngoài
forest	rừng
forever	mãi mãi
forget	quên
forgive	tha, tha thứ
fork	cái nĩa
form	hình thể, hình dạng, hình thức, làm thành, được tạo thành
formal	hình thức
formally	chính thức
format	định dạng
formation	sự hình thành
former	trước, cũ, xưa, nguyên
formerly	trước đây, thuở xưa
formula	công thức, thể thức, cách thức
forth	ra
fortunately	may mắn
fortune	sự giàu có, sự thịnh vượng
forty	bốn mươi
forum	diễn đàn
forward	ở phía trước, tiến về phía trước
foster	nuôi dưỡng
found	tìm, tìm thấy
foundation	sự thành lập, sự sáng lập, tổ chức
founder	người sáng lập
four	bốn
fourth	thứ tư
fraction	phân số
fragile	mong manh
fragment	miếng
frame	cấu trúc, hệ thống, dàn xếp, bố trí
framework	khuôn khổ
franchise	nhượng quyền thương mại
frankly	thẳng thắn
fraud	gian lận
free	miễn phí, tự do, giải phóng, trả tự do
freedom	sự tự do, nền tự do
freely	tự do, thoải mái
freeze	sự đông lạnh, sự giá lạnh, làm đông, làm đóng băng
french	người pháp
frequency	tần số
frequent	thường xuyên
frequently	thường xuyên
fresh	tươi, tươi tắn
freshly	tươi mát, khỏe khoắn
freshman	sinh viên năm nhất
friday	thứ sáu
fridge	tủ lạnh
friend	người bạn
friendly	thân thiện, thân mật
friendship	tình bạn, tình hữu nghị
frighten	làm sợ, làm hoảng sợ
frightened	hoảng sợ, khiếp sợ
frightening	kinh khủng, khủng khiếp
from	từ
front	mặt, đằng trước, về phía trước
frontier	biên giới
frown	nhăn mặt
frozen	lạnh giá
fruit	quả, trái cây
frustrate	thất vọng
frustration	thất vọng
fry	rán, chiên, thịt rán
fuck	quan hệ tình dục
fucking	fucking
fuel	chất đốt, nhiên liệu
full	đầy, đầy đủ
full-time	toàn thời gian
fully	đầy đủ, hoàn toàn
fun	sự vui đùa, sự vui thích, hài hước
function	chức năng, họat động, chạy
functional	chức năng
fund	kho, quỹ, tài trợ, tiền bạc, để tiền vào công quỹ
fundamental	cơ bản, cơ sở, chủ yếu
funding	kinh phí
funeral	lễ tang, đám tang
funny	buồn cười, khôi hài
fur	bộ da lông thú
furniture	đồ đạc
further	xa hơn nữa, thêm nữa
further, furthest	cấp so sánh của far
furthermore	hơn nữa
future	tương lai
gain	lợi, lợi ích, giành được, kiếm được, đạt tới
galaxy	thiên hà
gallery	bộ sưu tập
gallon	galông 1gl = 4, 54 lít ở anh, 3, 78 lít ở mỹ
gamble	đánh bạc, cuộc đánh bạc
gambling	trò cờ bạc
game	trò chơi
gang	băng nhóm
gap	đèo, lỗ hổng, kẽ hở, chỗ trống
garage	nhà để ô tô
garbage	lòng, ruột
garden	vườn
garlic	tỏi
gas	khí, hơi đốt
gasoline	dầu lửa, dầu hỏa, xăng
gate	cổng
gather	tập hợp, hái, lượm, thu thập
gathering	thu thập
gay	gay
gaze	nhìn chằm chằm
gear	cơ cấu, thiết bị, dụng cụ
gender	giới tính
gene	gen
general	chung, chung chung, tổng
generally	nói chung, đại thể
generate	sinh, đẻ ra
generation	sự sinh ra, sự phát sinh ra, thế hệ, đời
generous	rộng lượng, khoan hồng, hào phóng
generously	rộng lượng, hào phóng
genetic	di truyền
genius	thiên tài
genre	thể loại
gentle	hiền lành, dịu dàng, nhẹ nhàng
gentleman	người quý phái, người thượng lưu
gently	nhẹ nhàng, êm ái, dịu dàng
genuine	thành thật, chân thật, xác thực
genuinely	thành thật, chân thật
geography	địa lý, khoa địa lý
german	tiếng Đức
gesture	cử chỉ
get	được, có được
get off	ra khỏi, thoát khỏi
get on leo	trèo lên
ghost	ma
giaalmost	hầu như, gần như
giant	người khổng lồ, người phi thường, khổng lồ, phi thường
gift	quà tặng
gifted	năng khiếu
girl	con gái
girlfriend	bạn gái, người yêu
give	cho, biếu, tặng
give birth	sinh ra
give sth away	cho, phát
give sth out	chia, phân phối
give up	bỏ, từ bỏ
given	được
glad	vui lòng, sung sướng
glance	nháy mắt
glass	kính, thủy tinh, cái cốc, ly
glasses	kính đeo mắt
glimpse	nhìn thoáng qua
global	toàn cầu, toàn thể, toàn bộ
globe	quả địa cầu
glory	vinh quang
glove	bao tay, găng tay
glue	keo, hồ, gắn lại, dán bằng keo, hồ
go	đi
go down	đi xuống
go up	đi lên
go wrong	mắc lỗi, sai lầm
goal	mục tiêu
goat	con dê
god	thần, chúa
gold	vàng, bằng vàng
golden	vàng
golf	golf
good	tốt, hay, tuyệt, điều tốt, điều thiện
good at	tiến bộ ở
good for	có lợi cho
good, well	tốt, khỏe
goodbye exclamation,	tạm biệt, lời chào tạm biệt
goods	của cải, tài sản, hàng hóa
govern	cai trị, thống trị, cầm quyền
government	chính phủ, nội các, sự cai trị
governor	thủ lĩnh, chủ, kẻ thống trị
grab	túm lấy, vồ, chộp lấy
grace	ân sủng
grade	điểm, điểm số, phân loại, xếp loại
gradual	dần dần, từng bước một
gradually	dần dần, từ từ
graduate	tốt nghiệp
graduation	tốt nghiệp
grain	thóc lúa, hạt, hột, tính chất, bản chất
gram	đậu xanh
grammar	văn phạm
grand	rộng lớn, vĩ đại
grandchild	cháu
granddaughter	cháu gái
grandfather	ông
grandmother	bà
grandparent	ông bà
grandson	cháu trai
grant	cho, ban, cấp, sự cho, sự ban, sự cấp
grape	giống nho
grasp	sự hiểu biết
grass	cỏ, bãi cỏ, đồng cỏ
grateful	biết ơn, dễ chịu, khoan khoái
grave	mộ, dấu huyền, trang nghiêm, nghiêm trọng
gravity	nghiêm trọng
gray	xám, hoa râm
great	to, lớn, vĩ đại
greatest	vĩ đại nhất
greatly	rất, lắm, cao thượng, cao cả
greek	người hy lạp
green	xanh lá cây
greet	chào hỏi
grey	xám, hoa râm
grief	đau buồn
grin	nụ cười
grip	nắm chặt
groceries	hàng tạp hóa
grocery	cửa hàng tạp phẩm
gross	tổng
ground	mặt đất, đất, bãi đất
group	nhóm
grow	mọc, mọc lên
grow up	lớn lên, trưởng thành
growing	phát triển
growth	sự lớn lên, sự phát triển
guarantee	sự bảo hành, bảo lãnh, người bảo lãnh, cam đoan, bảo đảm
guard	cái chắn, người bảo vệ, bảo vệ, gác, canh giữ
guess	đoán, phỏng đoán, sự đoán, sự ước chừng
guest	khách, khách mời
guidance	hướng dẫn
guide	điều chỉ dẫn, người hướng dẫn, dẫn đường, chỉ đường
guideline	hướng dẫn
guilt	tội lỗi
guilty	có tội, phạm tội, tội lỗi
guitar	đàn ghi ta
gun	súng
gut	ruột
guy	bù nhìn, anh chàng, gã
gym	phòng thể dục
ha	ha
habit	thói quen, tập quán
habitat	môi trường sống
hair	tóc
hairdresser	thợ làm tóc
half	một nửa, phần chia đôi, nửa giờ, nửa
halfway	nửa chừng
hall	đại sảnh, tòa , hội trường
hallway	hành lang
hammer	búa
hand	tay, bàn tay, trao tay, truyền cho
handful	ít
handle	treo, mắc
handsome	đẹp
hang	treo
happen	xảy ra, xảy đến
happily	sung sướng, hạnh phúc
happiness	sự sung sướng, hạnh phúc
happy	vui sướng, hạnh phúc
harassment	quấy rối
hard	cứng, rắn, hà khắc, hết sức cố gắng, tích cực
hardly	khắc nghiệt, nghiêm khắc, tàn tệ, khó khăn
hardware	phần cứng
harm	thiệt hại, tổn hao, làm hại, gây thiệt hại
harmful	gây tai hại, có hại
harmless	không có hại
harmony	hòa hợp
harsh	khắc nghiệt
harvest	mùa gặt
hat	cái mũ
hate	ghét, lòng căm ghét, thù hận
hatred	lòng căm thì, sự căm ghét
haul	lôi
have	có
have auxiliary	có
have to modal	phải
hazard	nguy hiểm
he	nó, anh ấy, ông ấy
head	cái đầu , chỉ huy, lãnh đại, dẫn đầu
headache	chứng nhức đầu
headline	tiêu đề
headquarters	trụ sở chính
heal	chữa khỏi, làm lành
health	sức khỏe, thể chất, sự lành mạnh
healthy	khỏe mạnh, lành mạnh
hear	nghe
hearing	sự nghe, thính giác
heart	tim, trái tim
heat	hơi nóng, sức nóng
heating	sự đốt nóng, sự làm nóng
heaven	thiên đường
heavily	nặng, nặng nề
heavy	nặng, nặng nề
heel	gót chân
height	chiều cao, độ cao, đỉnh, điểm cao
helicopter	máy bay trực thăng
hell	địa ngục
hello	chào, xin chào, lời chào
helmet	mũ bảo hiểm
help	giúp đỡ, sự giúp đỡ
helpful	có ích, giúp đỡ
hence	sau đây, kể từ đây, do đó, vì thế
her	nó, chị ấy, cô ấy, bà ấy
herb	thảo mộc
here	đây, ở đây
heritage	gia tài
hero	người anh hùng
hers	cái của nó, cái của cô ấy, cái của chị ấy, cái của bà ấy
herself	chính nó, chính cô ta, chính chị ta, chính bà ta
hesitate	ngập ngừng, do dự
hey	chào
hi	xin chào
hidden	ẩn
hide	trốn, ẩn nấp, che giấu
high	cao, ở mức độ cao
high-tech	công nghệ cao
highlight	làm nổi bật, nêu bật, chỗ nổi bật nhất, đẹp, sáng nhất
highly	tốt, cao, hết sức, ở mức độ cao
highway	đường quốc lộ
hike	đi lang thang
hill	đồi
him	nó, hắn, ông ấy, anh ấy
himself	chính nó, chính hắn, chính ông ta, chính anh ta
hint	dấu
hip	hông
hire	thuê, cho thuê , sự thuê, sự cho thuê
his	của nó, của hắn, của ông ấy, của anh ấy, cái của nó, cái của hắn, cái của ông ấy, cái của anh ấy
hispanic	người hispanic
historian	nhà sử học
historic	mang tính lịch sử
historical	lịch sử, thuộc lịch sử
historically	lịch sử
history	lịch sử, sử học
hit	đánh, đấm, ném trúng, đòn, cú đấm
hoanloose	lỏng, không chặt
hobby	sở thích riêng
hockey	khúc côn cầu
hoever	ai, người nào, bất cứ ai, bất cứ người nào, dù ai
hold	cầm, nắm, giữ, sự cầm, sự nắm giữ
hole	lỗ, lỗ trống, hang
holiday	ngày lễ, ngày nghỉ
hollow	rỗng, trống rỗng
holy	linh thiêng, sùng đạo
home	nhà, ở tại nhà, nước mình
homeland	quê hương
homeless	vô gia cư
homework	bài tập về nhà , công việc làm ở nhà
honest	lương thiện, trung thực, chân thật
honestly	lương thiện, trung thực, chân thật
honey	mật ong
honor	tôn vinh
honour	danh dự, thanh danh, lòng kính trọng
hook	cái móc, bản lề, lưỡi câu
hope	hy vọng, nguồn hy vọng
hopefully	hy vọng
horizon	đường chân trời
hormone	hoocmon
horn	sừng
horrible	kinh khủng
horror	điều kinh khủng, sự ghê rợn
horse	ngựa
hospital	bệnh viện, nhà thương
host	chủ nhà, chủ tiệc, dẫn
hostage	con tin
hostile	hostile
hot	nóng, nóng bức
hotel	khách sạn
hour	giờ
house	nhà, căn nhà, toàn nhà
household	hộ, gia đình,  gia đình
housing	nơi ăn chốn ở
how	thế nào, như thế nào, làm sao, ra sao
however	tuy nhiên, tuy vậy, dù thế nào
hug	ôm
huge	to lớn, khổng lồ
huh	huh
human	con người, loài người
humanity	nhân loại
humor	hài hước
humorous	hài hước, hóm hỉnh
humour	sự hài hước, sự hóm hỉnh
hundred	hàng trăm
hunger	đói
hungry	đó
hunt	săn, đi săn
hunter	thợ săn
hunting	sự đi săn
hurricane	bão
hurry	sự vội vàng, sự gấp rút
hurt	làm bị thương, gây thiệt hại
husband	người chồng
hypothesis	giả thuyết
i	tôi
ice	băng, nước đá
ice cream	kem
icon	biểu tượng
idea	ý tưởng, quan niệm
ideal	quan niệm, tư tưởng, lý tưởng
ideally	lý tưởng, đúng như lý tưởng
identical	giống nhau
identification	nhận biết
identify	nhận biết, nhận ra, nhận dạng
identity	cá tính, nét nhận dạng, tính đồng nhất, giống hệt
ideological	ý thức hệ
ideology	hệ tư tưởng
ie	nghĩa là
if	nếu, nếu như
ignore	phớt lờ, tỏ ra không biết đến
ill	ốm
illegal	trái luật, bất hợp pháp
illegally	trái luật, bất hợp pháp
illness	sự đau yếu, ốm, bệnh tật
illusion	ảo giác
illustrate	minh họa, làm rõ ý
image	ảnh, hình ảnh
imaginary	tưởng tượng, ảo
imagination	trí tưởng tượng, sự tưởng tượng
imagine	tưởng tượng, hình dung, tưởng rằng, cho rằng
immediate	lập tức, tức thì
immediately	ngay lập tức
immigrant	di trú
immigration	nhập cư
immoral	trái đạo đức, luân lý, xấu xa
immune	miễn dịch
impact	sự và chạm, sự tác động, ảnh hưởng
impatient	thiếu kiên nhẫn, nóng vội
impatiently	nóng lòng, sốt ruột
implement	thực hiện
implementation	thực hiện
implication	sự lôi kéo, sự liên can, điều gợi ý
imply	ngụ ý, bao hàm
import	sự nhập, sự nhập khẩu, nhập, nhập khẩu
importance	sự quan trọng, tầm quan trọng
important	quan trọng, hệ trọng
importantly	quan trọng, trọng yếu
impose	đánh , bắt gánh vác, đánh tráo, lợi dụng
impossible	không thể làm được, không thể xảy ra
impress	ghi, khắc, in sâu vào, gây ấn tượng, làm cảm động
impressed	được ghi, khắc, in sâu vào
impression	ấn tượng, cảm giác, sự in, đóng dấu
impressive	gấy ấn tượng mạnh, hùng vĩ, oai vệ
improve	cải thiện, cái tiến, mở mang
improved	cải tiến
improvement	sự cái thiện, sự cải tiến, sự mở mang
impulse	thúc đẩy
in	ở, tại, trong, vào
in addition	thêm vào
in advance	trước, sớm
in case	nếu......
in charge of	phụ trách
in common	sự chung, của chung
in exchange	trong việc trao đổi về
in favour/favor	ủng hộ cái gì
in front	ở phía trước
in general	nói chung, đại khái
in memory of	sự tưởng nhớ
in order to	hợp lệ
in public	giữa công chúng, công khai
in spite of	mặc dù, bất chấp
in the end	cuối cùng, về sau
inability	sự bất lực, bất tài
incentive	khuyến khích
inch	insơ
incident	việc xảy ra, việc có liên quan
include	bao gồm, tính cả
including	bao gồm, kể cả
income	lợi tức, thu nhập
incorporate	kết hợp
increase	tăng, tăng thêm, sự tăng, sự tăng thêm
increased	tăng
increasing	tăng
increasingly	tăng thêm
incredible	đáng kinh ngạc
incredibly	vô cùng
indeed	thật vậy, quả thật
independence	sự độc lập, nền độc lập
independent	độc lập
independently	độc lập
index	chỉ số, sự biểu thị
indian	người Ấn Độ
indicate	chỉ, cho biết, biểu thị, trình bày ngắn gọn
indication	sự chỉ, sự biểu thị, sự biểu lộ
indicator	chỉ thị
indigenous	bản địa
indirect	gián tiếp
indirectly	gián tiếp
individual	riêng, riêng biệt, cá nhân
indoor	trong nhà
indoors	ở trong nhà
industrial	công nghiệp, kỹ nghệ
industry	công nghiệp, kỹ nghệ
inevitable	không thể tránh được, chắc chắn xảy ra, vẫn thường thấy, nghe
inevitably	chắc chắn
infant	trẻ sơ sinh
infect	nhiễm, tiêm nhiễm, đầu độc, lan truyền
infected	bị nhiễm, bị đầu độc
infection	sự nhiễm, sự đầu độc
infectious	lây, nhiễm
inflation	lạm phát
influence	sự ảnh hưởng, sự tác dụng, ảnh hưởng, tác động
influential	có ảnh hưởng
inform	báo cho biết, cung cấp tin tức
informal	không chính thức, không nghi thức
information	tin tức, tài liệu, kiến thức
infrastructure	cơ sở hạ tầng
ingredient	phần hợp thành, thành phần
inherent	vốn có
inherit	thừa kế
initial	ban đầu, lúc đầu, chữ đầu
initially	vào lúc ban đầu, ban đầu
initiate	bắt đầu
initiative	bước đầu, sự khởi đầu
injure	làm tổn thương, làm hại, xúc phạm
injured	bị tổn thương, bị xúc phạm
injury	sự làm tổn thương, làm hại, điều hại, điều tổn hại
ink	mực
inmate	tù nhân
inner	ở trong, nội bộ, thân cận
innocent	vô tội, trong trắng, ngây thơ
innovation	đổi mới
innovative	sáng tạo
input	đầu vào
inquiry	yêu cầu
insect	sâu bọ, côn trùng
insert	chèn vào, lồng vào
inside	mặt trong, phía, phần trong, ở trong, nội bộ
insight	cái nhìn sâu sắc
insist	cứ nhất định, cứ khăng khăng
inspection	kiểm tra
inspector	thanh tra
inspiration	cảm hứng
inspire	truyền cảm hứng
install	đặt
installation	cài đặt
instance	thí dị, ví dụ, trường hợp cá biệt
instant	tức thời
instantly	ngay lập tức
instead	để thay thế
instead of	thay cho
instinct	bản năng
institute	viện, học viện
institution	sự thành lập, lập, cơ quan, trụ sở
institutional	thể chế
instruct	dạy
instruction	sự dạy, tài liệu cung cấp
instructional	hướng dẫn
instructor	giảng viên
instrument	dụng cụ âm nhạc khí
insult	lăng mạ, xỉ nhục, lời lăng mạ, sự xỉ nhục
insulting	lăng mạ, xỉ nhục
insurance	sự bảo hiểm
intact	nguyên vẹn
integrate	tích hợp
integrated	tích hợp
integration	hội nhập
integrity	chính trực
intellectual	trí tuệ
intelligence	sự hiểu biết, trí thông minh
intelligent	thông minh, sáng trí
intend	ý định, có ý định
intended	có ý định, có dụng ý
intense	cường độ cao
intensity	cường độ
intent	ý định
intention	ý định, mục đích
interact	tương tác
interaction	sự tương tác
interest	sự thích thú, sự quan tâm, chú ý, làm quan tâm, làm chú ý
interested	có thích thú, có quan tâm, có chú ý
interesting	làm thích thú, làm quan tâm, làm chú ý
interfere	gây trở ngại
interior	phần trong, phía trong, ở trong, ở phía trong
internal	ở trong, bên trong, nội địa
international	quốc tế
internet	liên mạng
interpret	giải thích
interpretation	sự giải thích
interrupt	làm gián đoạn, ngắt lời
interruption	sự gián đoạn, sự ngắt lời
interval	khoảng , khoảng cách
intervention	can thiệp
interview	cuộc phỏng vấn, sự gặp mặt, phỏng vấn, nói chuyện riêng
intimate	thân mật
into	vào, vào trong
introduce	giới thiệu
introduction	sự giới thiệu, lời giới thiệu
invade	xâm chiếm
invasion	cuộc xâm lăng
invent	phát minh, sáng chế
invention	sự phát minh, sự sáng chế
inventory	hàng tồn kho
invest	đầu tư
investigate	điều tra, nghiên cứu
investigation	sự điều tra, nghiên cứu
investigator	điều tra viên
investment	sự đầu tư, vốn đầu tư
investor	nhà đầu tư
invisible	vô hình
invitation	lời mời, sự mời
invite	mời
involve	bao gồm, bao hàm, thu hút, dồn tâm trí
involved	có tính liên quan
involvement	sự gồm, sự bao hàm, sự để, dồn hết tâm trí vào
iraqi	iraqi
irish	người ailen
iron	sắt, bọc sắt
ironically	trớ trêu thay
irony	mỉa mai
irritate	làm phát cáu, chọc tức
irritated	tức giận, cáu tiết
irritating	làm phát cáu, chọc tức
islam	đạo hồi
islamic	hồi giáo
island	hòn đảo
isolate	cô lập
isolated	bị cô lập
isolation	cô lập
israeli	israeli
issue	sự phát ra, sự phát sinh, phát hành, đưa ra
it	cái đó, điều đó, con vật đó
italian	người Ý
item	tin tức, khoản.., món..., tiết mục
its	của cái đó, của điều đó, của con vật đó, cái của điều đó, cái của con vật đó
itself	chính cái đó, chính điều đó, chính con vật đó
jacket	áo vét
jail	nhà giam
jam	mứt
january	tháng giêng
japanese	tiếng nhật
jar	lọ
jaw	hàm
jazz	jazz
jealous	ghen,, ghen tị
jeans	quần bò, quần zin
jelly	thạch
jet	máy bay phản lực
jew	người do thái
jewellery	nữ trang, kim hoàn
jewelry	đồ trang sức
jewish	người do thái
job	việc, việc làm
join	gia nhập, tham gia, nối, chắp, ghép
joint	chung , chỗ nối, đầu nối
jointly	cùng nhau, cùng chung
joke	trò cười, lời nói đùa, nói đùa, giễu cợt
journal	tạp chí
journalism	báo chí
journalist	nhà báo
journey	cuộc hành trình , quãng đường, chặng đường đi
joy	niềm vui, sự vui mừng
judge	xét xử, phân xử, quan tòa, thẩm phán
judgement	sự xét xử
judgment	phán đoán
judicial	tư pháp
juice	nước ép
july	tháng 7
jump	nhảy, sự nhảy, bước nhảy
june	tháng 6
jungle	rừng nhiệt đới
junior	trẻ hơn, ít tuổi hơn, người ít tuổi hơn
jurisdiction	quyền hạn
juror	bồi thẩm đoàn
jury	ban bồi thẩm
just	đúng, vừa đủ, vừa mới, chỉ
justice	sự công bằng
justified	hợp lý, được chứng minh là đúng
justify	bào chữa, biện hộ
keen	sắc, bén
keen on	say mê, ưa thích
keep	giữ, giữ lại
key	chìa khóa, khóa, thuộc
keyboard	bàn phím
kick	đá, cú đá
kid	con dê non
kill	giết, tiêu diệt
killer	sát thủ
killing	sự giết chóc, sự tàn sát
kilogram	kilôgam
kilometre	kilômet
kind	loại, giống, tử tế, có lòng tốt
kindly	tử tế, tốt bụng
kindness	sự tử tế, lòng tốt
king	vua, quốc vương
kingdom	vương quốc
kiss	hôn, cái hôn
kit	bộ dụng cụ
kitchen	bếp
knee	đầu gối
kneel	quỳ xuống
knife	đan, thêu
knitted	được đan, được thêu
knitting	việc đan, hàng dệt kim
knock	đánh, đập, cú đánh
knot	cái nơ, điểm nút, điểm trung tâm
know	biết
knowledge	sự hiểu biết, tri thức
known	nổi tiếng
korean	hàn quốc
lab	phòng thí nghiệm
label	nhãn, mác, dán nhãn, ghi mác
labor	lao động
laboratory	phòng thí nghiệm
laboratory, lab	phòng thí nghiệm
labour	lao động, công việc
lack	sự thiếu, thiếu
lacking	ngu đần, ngây ngô
ladder	thang
lady	người yêu, vợ, quý bà, tiểu thư
lake	hồ
lamp	đèn
land	đất, đất canh tác, đất đai
landing	đổ bộ
landmark	mốc
landscape	phong cảnh
lane	đường nhỏ
language	ngôn ngữ
lap	vòng
large	rộng, lớn, to
largely	phong phú, ở mức độ lớn
laser	laser
last	lầm cuối, sau cùng, người cuối cùng, cuối cùng, rốt hết,
late	trễ, muộn
lately	gần đây
later	chậm hơn
latest	muộn nhất, chậm nhất, gần đây nhất
latin	latin
latter	sau cùng, gần đây, mới đây
laugh	cười, tiếng cười
laughter	tiếng cười
launch	hạ thủy , khai trương, sự hạ thủy, buổi giới thiệu sản phầm
laundry	giặt ủi
law	luật
lawmaker	nhà lập pháp
lawn	bãi cỏ
lawsuit	kiện tụng
lawyer	luật sư
lay	xếp, đặt, bố trí
layer	lớp
lazy	lười biếng
lead	lãnh đạo, dẫn dắt, sự lãnh đạo, sự hướng dẫn
leader	người lãnh đạo, lãnh tụ
leadership	khả năng lãnh đạo
leading	lãnh đạo, dẫn đầu
leaf	lá cây, lá
league	liên minh, liên hoàn
lean	nghiêng, dựa, ỷ vào
leap	nhảy vọt
learn	học, nghiên cứu
learning	học tập
least	tối thiểu, ít nhất
leather	da thuộc
leave	bỏ đi, rời đi, để lại
leave out	bỏ quên, bỏ sót
lecture	bài diễn thuyết, bài thuyết trình, bài nói chuyện
left	bên trái, về phía trái
leg	chân
legacy	di sản
legal	hợp pháp
legally	hợp pháp
legend	huyền thoại
legislation	pháp luật
legislative	lập pháp
legislator	nhà lập pháp
legislature	cơ quan lập pháp
legitimate	hợp pháp
lemon	quả chanh
lend	cho vay, cho mượn
length	chiều dài, độ dài
lens	ống kính
less	nhỏ bé, ít hơn, số lượng ít hơn
lesson	bài học
let	cho phép, để cho
letter	thư, chữ cái, mẫu tự
level	trình độ, cấp, vị trí, bằng, ngang bằng
liability	trách nhiệm pháp lý
liberal	tự do
liberty	tự do
library	thư viện
licence	bằng, chứng chỉ, bằng cử nhân, sự cho phép
license	cấp chứng chỉ, cấp bằng, cho phép
lid	nắp, vung
lie	nói dối, lời nói dối, sự dối trá
life	đời, sự sống
lifestyle	lối sống
lifetime	cả đời
lift	giơ lên, nhấc lên, sự nâng, sự nhấc lên
light	ánh sáng, nhẹ, nhẹ nhàng, đốt, thắp sáng
lighting	thắp sáng
lightly	nhẹ nhàng
lightning	sét đánh
like	giống như, thích, như
likelihood	khả năng
likely	có thể đúng, có thể xảy ra, có khả năng, có thể, chắc vậy
likewise	tương tự
limb	chân tay
limit	giới hạn, ranh giới, giới hạn, hạn chế
limitation	giới hạn
limited	hạn chế, có giới hạn
line	dây, đường, tuyến
link	mắt xích, mối liên lạc, liên kết, kết nối
lion	sư tử
lip	môi
liquid	chất lỏng, lỏng, êm ái, du dương, không vững
list	danh sách, ghi vào danh sách
listen	nghe, lắng nghe
listener	người nghe
literally	nghĩa đen
literary	văn chương
literature	văn chương, văn học
litre	lít
little	nhỏ, bé, chút ít, không nhiều, một chút
live	sống
lively	sống, sinh động
liver	gan
living	sống, đang sống
load	gánh nặng, vật nặng, chất, chở
loan	sự vay mượn
lobby	sảnh đợi
local	địa phương, bộ phận, cục bộ
locally	có tính chất địa phương, cục bộ
locate	xác định vị trí, định vị
located	định vị
location	vị trí, sự định vị
lock	khóa, khóa
log	đăng nhập
logic	lô gic
logical	hợp lý, hợp logic
lonely	cô đơn, bơ vơ
long	dài, xa, lâu
long-term	dài hạn
longtime	thời gian dài
look	nhìn, cái nhìn
look after	trông nom, chăm sóc
look at	nhìn, ngắm, xem
look for	tìm kiếm
look forward to	mong đợi cách hân
loop	vòng lặp
loose	lỏng lẻo
loosely	lỏng lẻo
lord	chúa, vua
lorry	xe tải
lose	mất, thua, lạc
loss	sự mất, sự thua
lost	thua, mất
lot	số lượng lớn, rất nhiều
lots	rất nhiều
loud	to, inh ỏi, ầm ĩ, to, lớn
loudly	ầm ĩ, inh ỏi
love	tình yêu, lòng yêu thương, yêu, thích
lovely	đẹp, xinh xắn, có duyên
lover	người yêu, người tình
low	thấp, bé, lùn
lower	thấp hơn
loyal	trung thành, trung kiên
loyalty	lòng trung thành
luck	may mắn, vận may
lucky	gặp may, gặp may mắn, hạnh phúc
luggage	hành lý
lump	cục, tảng, miếng, cái bướu
lunch	bữa ăn trưa
lung	phổi
machine	máy, máy móc
machinery	máy móc, thiết bị
mad	điên, mất trí, bực điên người
magazine	tạp chí
magic	ma thuật, ảo thuật,  ma thuật, ảo thuật
magnetic	từ tính
magnitude	độ lớn
mail	thư từ, bưu kiện, gửi qua bưu điện
main	chính, chủ yếu, trọng yếu nhất
mainly	chính, chủ yếu, phần lớn
mainstream	dòng chính
maintain	giữ gìn, duy trì, bảo vệ
maintenance	bảo trì
major	lớn, nhiều hơn, trọng đại, chủ yếu
majority	phần lớn, đa số, ưu thế
make	làm, chế tạo, sự chế tạo
make fun of	đùa cợt, chế giễu, chế nhạo
make sth up	làm thành, cấu thành, gộp thành
make sure	chắc chắn, làm cho chắc chắn
make-up	đồ hóa trang, son phấn
maker	nhà sản xuất
makeup	trang điểm
male	trai, trống, đực, con trai, đàn ông, con trống, đực
mall	búa
man	con người, đàn ông
manage	quản lý, trông nom, điều khiển
management	sự quản lý, sự trông nom, sự điều khiển
manager	người quản lý, giám đốc
managing	quản lý
mandate	ủy nhiệm
manipulate	vận dụng
manner	cách, lối, kiểu, dáng, vẻ, thái độ
mansion	biệt thự
manual	sổ tay
manufacturer	người chế tạo, người sản xuất
manufacturing	sự sản xuất, sự chế tạo
many	nhiều
map	bản đồ
marble	đá hoa
march	diễu hành, hành quân, cuộc hành quân, cuộc diễu hành
margin	lề
marine	biển
mark	dấu, nhãn, nhãn mác, đánh dấu, ghi dấu
marker	đánh dấu
market	chợ, thị trường
marketing	ma-kết-tinh
marketplace	thương trường
marriage	sự cưới xin, sự kết hôn, lễ cưới
married	cưới, kết hôn
marry	cưới
mask	mặt nạ
mass	khối, khối lượng, quần chúng, đại chúng
massive	to lớn, đồ sộ
master	chủ, chủ nhân, thầy giáo, thạc sĩ
match	trận thi đấu, đối thủ, địch thủ, đối chọi, sánh được
matching	tính địch thù, thi đấu
mate	bạn, bạn nghề, giao phối
material	nguyên vật liệu, vật chất, hữu hình
math	môn toán
mathematics	toán học, môn toán
matter	chất, vật chất, có ý nghĩa, có tính chất quan trọng
maximum	cực độ, tối đa, trị số cực đại, lượng cực đại, cực độ
may	tháng 5
may modal	có thể, có lẽ
maybe	có thể, có lẽ
mayor	thị trưởng
me	tôi, tao, tớ
meal	bữa ăn
mean	nghĩa, có nghĩa là
meaning	ý, ý nghĩa
meaningful	có ý nghĩa
means	của cải, tài sản, phương tiện
meantime	thời gian chờ đợi
meanwhile	trong lúc đó, trong lúc ấy
measure	đo, đo lường, sự đo lường, đơn vị đo lường
measurement	sự đo lường, phép đo
meat	thịt
mechanic	thợ cơ khí
mechanical	cơ khí
mechanism	cơ chế
medal	huy chương
media	phương tiện truyền thông đại chúng
medical	y học
medication	thuốc men
medicine	y học, y khoa, thuốc
medium	trung bình, trung, vừa, sự trung gian, sự môi giới
meet	gặp, gặp gỡ
meeting	cuộc mít tinh, cuộc biểu tình
melt	tan ra, chảy ra, làm tan chảy ra
member	thành viên, hội viên
membership	tư cách hội viên, địa vị hội viên
memory	bộ nhớ, trí nhớ, kỉ niệm
mental	trí tuệ, trí óc, mất trí
mentally	về mặt tinh thần
mention	kể ra, nói đến, đề cập
mentor	người cố vấn
menu	thực đơn
merchant	thương gia
mere	chỉ là
merely	chỉ, đơn thuần
merit	n  Xứng đáng
mess	tình trạng bừa bộn, tình trạng lộn xộn, người nhếch nhác, bẩn thỉu
message	tin nhắn, thư tín, điện thông báo, thông điệp
metal	kim loại
metaphor	phép ẩn dụ
meter	mét
method	phương pháp, cách thức
metre	mét
metropolitan	đô thị
mexican	mexico
mid- combining form	tiền tố: một nửa
midday	trưa, buổi trưa
middle	giữa, ở giữa
middle-class	tầng lớp trung lưu
midnight	nửa đêm, 12h đêm
midst	giữa
might	có thể
might modal	qk. may có thể, có lẽ
migration	di cư
mild	nhẹ, êm dịu, ôn hòa
mile	dặm
military	quân đội, quân sự
milk	sữa
mill	cối xay
milligram	mi-li-gam
millimetre	mi-li-met
million	triệu
mind	tâm trí, tinh thần, trí tuệ, chú ý, để ý, chăm sóc, quan tâm
mine	của tôi
mineral	công nhân, thợ mỏ, khoáng
minimal	tối thiểu
minimize	giảm thiểu
minimum	tối thiểu, số lượng tối thiểu, mức tối thiểu
minister	bộ trưởng
ministry	bộ
minor	nhỏ hơn, thứ yếu, không quan trọng
minority	phần ít, thiểu số
minute	phút
miracle	phép màu
mirror	gương
miss	cô gái, thiếu nữ
missile	tên lửa
missing	vắng, thiếu, thất lạc
mission	sứ mệnh
missionary	nhà truyền giáo
mistake	lỗi, sai lầm, lỗi lầm, phạm lỗi, phạm sai lầm
mistaken	sai lầm, hiểu lầm
mix	pha, trộn lẫn, sự pha trộn
mixed	lẫn lộn, pha trộn
mixture	sự pha trộn, sự hỗn hợp
mm-hmm	mm-hmm
mobile	chuyển động, di động
mobile phone	điện thoại đi động
mode	chế độ
model	mẫu, kiểu mẫu
moderate	vừa phải
modern	hiện đại, tân tiến
modest	khiêm tốn
modify	sửa đổi
molecule	phân tử
mom	mẹ
moment	chốc, lát
momentum	Đà
monday	thứ 2
money	tiền
monitor	lớp trưởng, màn hình máy tính, nghe, ghi phát thanh, giám sát
monkey	con khỉ
monster	quái vật
month	tháng
monthly	hàng tháng
monument	tượng đài
mood	lối, thức, điệu
moon	mặt trăng
moral	đạo đức, luân lý, phẩm hạnh, có đạo đứcmorally adv. có đạo đức
more	hơn, nhiều hơn
moreover	hơn nữa, ngoài ra, vả lại
morning	buổi sáng
mortality	tử vong
mortgage	thế chấp
most	lớn nhất, nhiều nhất, nhất, hơn cả
mostly	hầu hết, chủ yếu là
mother	mẹ
motion	sự chuyển động, sụ di động
motivate	động viên
motivation	động lực
motive	động cơ
motor	động cơ mô tô
motorcycle	xe mô tô
mount	leo, trèo, núi
mountain	núi
mouse	chuột
mouth	miệng
move	di chuyển, chuyển động, sự di chuyển, sự chuyển động
movement	sự chuyển động, sự hoạt động, cử động, động tác
movie	phim xi nê
movie theater	rạp chiếu phim
moving	động, hoạt động
mr	Ông
mrs	bà
ms	cô
much	nhiều, lắm
mud	bùn
multiple	nhiều
multiply	nhân lên, làm tăng lên nhiều lần, sinh sôi nảy nở
mum	mẹ
municipal	thành phố
murder	tội giết người, tội ám sát, giết người, ám sát
muscle	cơ, bắp thịt
museum	bảo tàng
mushroom	nấm
music	nhạc, âm nhạc
musical	nhạc, âm nhạc, du dương, êm ái
musician	nhạc sĩ
muslim	hồi giáo
must	phải
must modal	phải, cần, nên làm
mutter	lẩm bẩm
mutual	lẫn nhau
my	của tôi
myself	tự tôi, chính tôi
mysterious	thần bí, huyền bí, khó hiểu
mystery	điều huyền bí, điều thần bí
myth	huyền thoại
n't	không
nail	móng  móng vuốt
naked	trần, khỏa thân, trơ trụi
name	tên, đặt tên, gọi tên
narrative	tường thuật
narrow	hẹp, chật hẹp
nasty	bẩn thỉu
nation	dân tộc, quốc gia
national	quốc gia, dân tộc
nationwide	toàn quốc
native	tự nhiên
natural	tự nhiên, thiên nhiên
naturally	vốn, tự nhiên, đương nhiên
nature	tự nhiên, thiên nhiên
naval	hải quân
navy	hải quân
near	gần, cận, ở gần
nearby	gần
nearly	gần, sắp, suýt
neat	sạch, ngăn nắp, rành mạch
neatly	gọn gàng, ngăn nắp
necessarily	tất yếu, nhất thiết
necessary	cần, cần thiết, thiết yếu
necessity	sự cần thiết
neck	cổ
need	nhu cầu
need modal	cần, đòi hỏi, sự cần
needle	cái kim, mũi nhọn
negative	phủ định
negotiate	đàm phán
negotiation	đàm phán
neighbor	hàng xóm
neighborhood	khu vực lân cận
neighboring	lân cận
neighbour	hàng xóm
neighbourhood	hàng xóm, làng giềng
neither	không này mà cũng không kia
nephew	cháu trai
nerve	khí lực, thần kinh, can đảm
nervous	hoảng sợ, dễ bị kích thích, hay lo lắng
nervously	bồn chồn, lo lắng
nest	tổ, ổ, làm tổ
net	lưới, mạng
network	mạng lưới, hệ thống
neutral	trung tính
never	không bao giờ, không khi nào
nevertheless	tuy nhiên, tuy thế mà
new	mới, mới mẻ, mới lạ
newly	mới
news	tin, tin tức
newspaper	báo
next	sát, gần, bên cạnh, lần sau, tiếp nữa
next to	gần
nice	đẹp, thú vị, dễ chịu
nicely	thú vị, dễ chịu
niece	cháu gái
night	đêm, tối
nightmare	ác mộng
nine	chín
no	không
no exclamation,	không
nobody	không ai, không người nào
nod	gật đầu
noise	tiếng ồn, sự huyên náo
noisily	ồn ào, huyên náo
noisy	ồn ào, huyên náo
nomination	đề cử
nominee	ứng cử viên
none	không ai, không người, vật gì
nonetheless	dù sao
nonprofit	phi lợi nhuận
nonsense	lời nói vô lý, vô nghĩa
noon	trưa
nor	cũng không
norm	định mức
normal	thường, bình thường, tình trạng bình thường
normally	thông thường, như thường lệ
north	phía bắc, phương bắc
northeast	đông bắc
northern	bắc
northwest	tây bắc
nose	mũi
not	không
note	lời ghi, lời ghi chép, ghi chú, ghi chép
notebook	sổ tay
nothing	không gì, không cái gì
notice	thông báo, yết thị, chú ý, để ý, nhận biết
noticeable	đáng chú ý, đáng để ý
notion	khái niệm
novel	tiểu thuyết, truyện
november	tháng 11
now	bây giờ, hiện giờ, hiện nay
nowhere	không nơi nào, không ở đâu
nuclear	hạt nhân
number	số
numerous	nhiều
nurse	quả hạch, đầu
nut	hạt
nutrient	chất dinh dưỡng
o'clock	giờ
oak	cây sồi
obey	vâng lời, tuân theo, tuân lệnh
object	vật, vật thể, phản đối, chống lại
objection	sự phản đối
objective	mục tiêu, mục đích,  mục tiêu, khách quan
obligation	nghĩa vụ
observation	sự quan sát, sự theo dõi
observe	quan sát, theo dõi
observer	người quan sát
obstacle	trở ngại
obtain	đạt được, giành được
obvious	rõ ràng, rành mạch, hiển nhiên
obviously	một cách rõ ràng, có thể thấy được
occasion	dịp, cơ hội
occasional	thỉnh thoảng
occasionally	thỉnh thoảng, đôi khi
occupation	nghề nghiệp
occupied	đang sử dụng, đầy
occupy	giữ, chiếm lĩnh, chiếm giữ
occur	xảy ra, xảy đến, xuất hiện
ocean	đại dương
odd	kỳ quặc, kỳ cục, lẻ
oddly	kỳ quặc, kỳ cục, lẻ
odds	tỷ lệ
of	của
of course	dĩ nhiên
off	tắt, khỏi, cách, rời
offence	sự vi phạm, sự phạm tội
offend	xúc phạm, làm bực mình, làm khó chịu
offender	tội phạm
offense	xúc phạm
offensive	sự tấn công, cuộc tấn công
offer	biếu, tặng, cho, sự trả giá
offering	chào bán
office	cơ quan, văn phòng, bộ
officer	viên chức, cảnh sát, sĩ quan
official	chính quyền, văn phòng, viên chức, công chức
officially	một cách trịnh trọng, một cách chính thức
often	thường, hay, luôn
oh	oh
oh exclamation	chao, ôi chao, chà, này..
oil	dầu
ok	được
ok  exclamation,	đồng ý, tán thành
okay	đuợc
old	già
old-fashioned	lỗi thời
olympic	olympic
olympics	thế vận hội
on	trên, ở trên, tiếp tục, tiếp diễn
on behalf of sb	thay mặt cho ai, nhân danh ai
on board	trên tàu thủy
on purpose	cố tình, cố ý, có chủ tâm
on sb’s behalf	nhân danh cá nhân ai
once	một lần, khi mà, ngay khi, một khi
one	một
one number,	một, một người, một vật nào đó
one-third	một phần ba
ongoing	đang diễn ra
onion	củ hành
online	trực tuyến
only	chỉ có 1, duy nhất, chỉ, mới
onto	về phía trên, lên trên
open	mở, ngỏ, mở, bắt đầu, khai mạc
opening	khe hở, lỗ, sự bắt đầu, sự khai mạc, lễ khánh thành
openly	công khai, thẳng thắn
opera	opera
operate	hoạt động, điều khiển
operating	điều hành
operation	sự hoạt động, quá trình hoạt động
operator	nhà điều hành
opinion	ý kiến, quan điểm
opponent	địch thủ, đối thủ, kẻ thù
opportunity	cơ hội, thời cơ
oppose	đối kháng, đối chọi, đối lập, chống đối, phản đối
opposed	phản đối
opposed to	chống lại, phản đối
opposing	tính đối kháng, đối chọi
opposite	đối nhau, ngược nhau, trước mặt, đối diện, điều
opposition	sự đối lập, sự đối nhau, sự chống lại, sự phản đối, phe đối
opt	opt
optimistic	lạc quan
option	sự lựa chọn
or	hoặc là
oral	miệng
orange	quả cam, có màu da cam
orbit	quỹ đạo
order	thứ, bậc, ra lệnh
ordinary	thường, thông thường
organ	đàn óoc gan
organic	hữu cơ
organism	cơ thể
organization	tổ chức, cơ quan, sự tổ chức
organizational	tổ chức
organize	tổ chức, thiết lập
organized	có trật tự, ngăn nắp, được sắp xếp, được tổ chức
orientation	sự định hướng
origin	gốc, nguồn gốc, căn nguyên
original	gốc, nguồn gốc, căn nguyên, nguyên bản
originally	một cách sáng tạo, mới mẻ, độc đáo, khởi đầu, đầu tiên
other	khác
others	khác
otherwise	khác, cách khác, nếu không thì..., mặt khác
ought	nên
ought to modal	phải, nên, hẳn là
our	của chúng ta, thuộc chúng ta, của chúng tôi, của chúng mình
ours	của chúng ta, thuộc chúng ta, của chúng tôi, của chúng mình
ourselves	bản thân chúng ta, bản thân chúng tôi, bản thân chúng mình, tự chúng mình
out	ngoài, ở ngoài, ra ngoài
outcome	kết quả
outdoor	ngoài trời, ở ngoài
outdoors	ở ngoài trời, ở ngoài nhà
outer	ở phía ngoài, ở xa hơn
outfit	trang phục
outlet	đầu ra
outline	vẽ, phác tảo, đường nét, hình dáng, nét ngoài
output	sự sản xuất, sản phẩm, sản lượng
outside	bề ngoài, bên ngoài, ở ngoài, ngoài
outsider	người ngoài
outstanding	nổi bật, đáng chú ý, còn tồn lại
oven	lò
over	bên trên, vượt qua, lên, lên trên
overall	toàn bộ, toàn thể, tất cả, bao gồm
overcome	thắng, chiến thắng, khắc phục, đánh bại
overlook	bỏ qua
overnight	qua đêm
oversee	giám sát
overwhelm	quá tải
overwhelming	áp đảo
owe	nợ, hàm ơn, có được
own	của chính mình, tự mình, nhận, nhìn nhận
owner	người chủ, chủ nhân
ownership	sở hữu
oxygen	ôxy
o’clock	đúng giờ
p.m.	quá trưa, chiều, tối
pace	bước chân, bước
pack	gói, bọc, bó, gói
package	gói đồ, bưu kiện, đóng gói, đóng kiện
packaging	bao bì
packet	gói nhỏ
pad	tập giấy
page	trang
pain	sự đau đớn, sự đau khổ
painful	đau đớn, đau khổ
paint	sơn, vôi màu, sơn, quét sơn
painter	họa sĩ
painting	sự sơn, bức họa, bức tranh
pair	đôi, cặp
palace	cung điện, lâu đài
pale	taí, nhợt
palestinian	palestine
palm	lòng bàn tay
pan	xoong, chảo
panel	ván ô , pa nô
panic	hoảng loạn
pants	quần lót, đùi
paper	giấy
parade	diễu hành
parallel	song song, tương đương
parent	cha, mẹ
parental	cha mẹ
parish	giáo xứ
park	công viên, vườn hoa, khoanh vùng thành công viên
parking	bãi đỗ xe
parliament	nghi viện, quốc hội
part	phần, bộ phận
partial	một phần
partially	một phần
participant	người tham gia
participate	tham dự
participation	sự tham gia
particle	hạt
particular	riêng biệt, cá biệt
particularly	một cách đặc biệt, cá biệt, riêng biệt
partly	đến chừng mực nào đó, phần nào đó
partner	đối tác, cộng sự
partnership	sự chung phần, sự cộng tác
party	tiệc, buổi liên hoan, đảng
pass	qua, vượt qua, ngang qua
passage	sự đi qua, sự trôi qua, hành lang
passenger	hành khách
passing	sự đi qua, sự trôi qua, thoáng qua, ngắn ngủi
passion	niềm đam mê
passport	hộ chiếu
past	quá khứ, dĩ vãng, quá, qua
pasta	mỳ ống
pastor	mục sư
pat	vỗ vỗ
patch	vá
patent	bằng sáng chế
path	đường mòn, hướng đi
patience	tính kiên nhẫn, nhẫn nại, kiên trì, sự chịu đựng
patient	bệnh nhân, kiên nhẫn, nhẫn nại, bền chí
patrol	tuần tra
patron	người bảo trợ
pattern	mẫu, khuôn mẫu
pause	tạm nghỉ, dừng, sự tạm nghỉ, sự tạm ngừng
pay	trả, thanh toán, nộp, tiền lương
payment	sự trả tiền, số tiền trả, tiền bồi thường
pc	pc
peace	hòa bình, sự hòa thuận
peaceful	hòa bình, thái bình, yên tĩnh
peak	lưỡi trai, đỉnh, chóp
peanut	đậu phụng
peasant	nông dân
peel	lột vỏ
peer	ngang nhau
pen	bút
penalty	hình phạt
pence	đồng xu
pencil	bút chì
penny	số tiền
pension	tiền trợ cấp, lương hưu
people	dân tộc, dòng giống, người
pepper	hạt tiêu, cây ớt
per	cho mỗi
per cent	phần trăm
perceive	nhận thức
perceived	lĩnh hội
percentage	phần trăm
perception	nhận thức
perfect	hoàn hảo
perfectly	một cách hoàn hảo
perform	biểu diễn, làm, thực hiện
performance	sự làm, sự thực hiện, sự thi hành, sự biểu diễn
performer	người biểu diễn, người trình diễn
perhaps	có thể, có lẽ
period	kỳ, thời kỳ, thời gian, thời đại
permanent	lâu dài, vĩnh cửu, thường xuyên
permanently	cách thường xuyên, vĩnh cửu
permission	sự cho phép, giấy phép
permit	cho phép, cho cơ hội
persian	người ba tư
persist	tồn tại
person	con người, người
personal	cá nhân, tư, riêng tư
personality	nhân cách, tính cách, nhân phẩm, cá tính
personally	đích thân, bản thân, về phần rôi, đối với tôi
personnel	nhân viên
perspective	quan điểm
persuade	thuyết phục
pet	cơn nóng giận, vật cưng, người được yêu thích
petrol	xăng dầu
phase	tuần trăng, giai đoạn, thời kỳ
phenomenon	hiện tượng
philosophical	triết học
philosophy	triết học, triết lý
phone	điện thoại
photo	hình chụp
photocopy	bản sao chụp, sao chụp
photograph	ảnh, bức ảnh, chụp ảnh
photographer	thợ chụp ảnh, nhà nhiếp ảnh
photography	thuật chụp ảnh, nghề nhiếp ảnh
phrase	câu, thành ngữ, cụm từ
physical	vật chất,  cơ thể, thân thể
physically	về thân thể, theo luật tự nhiên
physician	bác sĩ
physics	vật lý học
piano	đàn pianô, dương cầm
pick	cuốc
pick sth up	cuốc, vỡ, xé
pickup	nhặt lên
picture	bức vẽ, bức họa
pie	chiếc bánh
piece	mảnh, mẩu, đồng tiền
pig	con lợn
pile	cọc, chồng, đống, pin, đóng cọc, chất chồng
pill	viên thuốc
pillow	cái gối
pilot	phi công
pin	đinh ghim, ghim., kẹp
pine	cây thông
pink	màu hồng, hoa cẩm chướng, tình trạng tốt, hoàn hảo
pint	panh
pioneer	người tiên phong
pipe	ống dẫn
pistol	súng lục
pit	hố
pitch	sân , đầu hắc ín
pitcher	người bình
pity	lòng thương hại, điều đáng tiếc, đáng thương
pizza	pizza
place	nơi, địa điểm, quảng trường
placement	vị trí
plain	ngay thẳng, đơn giản, chất phác
plaintiff	nguyên đơn
plan	bản đồ, kế hoạch, vẽ bản đồ, lập kế hoạch, dự kiến
plane	mặt phẳng, mặt bằng
planet	hành tinh
planner	lập kế hoạch
planning	sự lập kế hoạch, sự quy hoạch
plant	thực vật, sự mọc lên, trồng, gieo
plastic	chất dẻo, làm bằng chất dẻo
plate	bản, tấm kim loại
platform	nền, bục, bệ, thềm, sân ga
play	chơi, đánh, sự vui chơi, trò chơi, trận đấu
player	người chơi 1 trò chơi nào đó
playoff	playoff
plea	lời bào chữa
plead	biện hộ
pleasant	vui vẻ, dễ thương, dịu dàng, thân mật
pleasantly	vui vẻ, dễ thương, thân mật
please	xin vui lòng
please exclamation,	làm vui lòng, vừa lòng, mong... vui lòng, xin mời
pleased	hài lòng
pleasing	mang lại niềm vui thích, dễ chịu
pleasure	niềm vui thích, điều thích thú, điều thú vị, ý muốn, ý thích
plenty	nhiều , chỉ sự thừa, sự sung túc, sự p.phú
plot	mảnh đất nhở, sơ đồ, đồ thị, đồ án, vẽ sơ đồ, dựng đồ án
plug	nút
plunge	lao xuống
plus	cộng với , dấu cộng, cộng, thêm vào
pm	pm
pocket	túi , túi tiền
poem	thi ca, chất thơ
poet	bài thơ
poetry	thơ phú
point	mũi nhọn, điểm, vót, làm nhọn, chấm
pointed	nhọn, có đầu nhọn
poison	chất độc, thuốc độc, đánh thuốc độc, tẩm thuốc độc
poisonous	độc, có chất độc, gây chết, bệnh
poke	xô
pole	người ba lan, cực
police	cảnh sát, công an
policeman	cảnh sát
policy	chính sách
polish	nước bóng, nước láng, đánh bóng, làm cho láng
polite	lễ phép, lịch sự
politely	lễ phép, lịch sự
political	về chính trị, về chính phủ, có tính chính trị
politically	về mặt chính trị, khôn ngoan, thận trọng, sảo quyệt
politician	nhà chính trị, chính khách
politics	họat động chính trị, đời sống chính trị, quan điểm chính trị
poll	thăm dò ý kiến
pollution	sự ô nhiễm
pond	ao
pool	vũng nước, bể bơi, hồ bơi
poor	nghèo
pop	tiếp bốp, phong cách dân gian hiện đại, nổ bốp
popular	có tính đại chúng,  nhân dân, được nhiều người ưa chuộng
popularity	phổ biến
population	dân cư, dân số, mật độ dân số
porch	hiên nhà
pork	thịt heo
port	cảng
portfolio	danh mục đầu tư
portion	phần
portrait	chân dung
portray	miêu tả
pose	đưa ra, đề ra, đặt, sự đặt, đề ra
position	vị trí, chỗ
positive	xác thực, rõ ràng, tích cực, lạc quan
possess	có, chiếm hữu
possession	quyền sở hữu, vật sở hữu
possibility	khă năng, triển vọng
possible	có thể, có thể thực hiện
possibly	có lẽ, có thể, có thể chấp nhận được
post	thư, bưu kiện, gửi thư
post office	bưu điện
poster	áp phích
pot	can, bình, lọ...
potato	khoai tây
potential	tiềm năng, khả năng, tiềm lực
potentially	tiềm năng, tiềm ẩn
pound	pao - đơn vị đo lường
pour	rót, đổ, giội
poverty	nghèo nàn
powder	bột, bụi
power	khả năng, tài năng, năng lực, sức mạnh, nội lực, quyền lực
powerful	hùng mạnh, hùng cường
practical	thực hành, thực tế
practically	về mặt thực hành, thực tế
practice	thực hành, thực tiễn
practise	thực hành, tập luyện
practitioner	học viên
praise	sự ca ngợi, sự tán dương, lòng tôn kính, tôn thờ, khen ngợi, tán dương
pray	cầu nguyện
prayer	sự cầu nguyện
preach	rao giảng
precious	quí
precise	rõ ràng, chính xác, tỉ mỉ, kỹ tính
precisely	đúng, chính xác, cần thận
predator	người ăn thịt
predict	báo trước, tiên đoán, dự báo
prediction	dự đoán
prefer	thích hơn
preference	sự thích hơn, sự ưa hơn, cái được ưa thích hơn
pregnancy	mang thai
pregnant	mang thai, giàu trí tưởng tượng, sáng tạo
preliminary	sơ bộ
premise	tiền đề
premises	biệt thự
premium	phí bảo hiểm
preparation	sự sửa soạn, sự chuẩn bị
prepare	sửa soạn, chuẩn bị
prepared	đã được chuẩn bị
prescription	đơn thuốc
presence	sự hiện diện, sự có mặt, người, vât hiện diện
present	có mặt, hiện diện, hiện nay, hiện thời, bày tỏ, giới thiệu, trình bày
presentation	bài thuyết trình, sự trình diện, sự giới thiệu
preserve	bảo quản, giữ gìn
presidency	chức tổng thống
president	hiệu trưởng, chủ tịnh, tổng thống
presidential	tổng thống
press	sự ép, sự nén, sự ấn, ép, nén, bóp, ấn
pressure	sức ép, áp lực, áp suất
presumably	có thể được, có lẽ
pretend	giả vờ, giả bộ, làm ra vẻ
pretty	khá, vừa phải, xinh, xinh xắn,, đẹp
prevail	chiếm ưu thế
prevent	ngăn cản, ngăn chặn, ngăn ngừa
prevention	phòng ngừa
previous	vội vàng, hấp tấp, trước , ưu tiên
previously	trước, trước đây
price	sự kiêu hãnh, sự hãnh diện, tính kiêu căng, tự phụ
pride	tự hào
priest	linh mục, thầy tu
primarily	trước hết, đầu tiên
primary	nguyên thủy, đầu tiên, thời cổ đại, nguyên sinh, sơ cấp, tiểu học
prime	nguyên tố
prime minister	thủ tướng
prince	hoành tử
princess	công chúa
principal	hiệu trưởng
principle	cơ bản, chủ yếu, nguyên lý, nguyên tắc
print	in, xuất bản, sự in ra
printer	máy in, thợ in
printing	sự in, thuật in, kỹ sảo in
prior	trước, ưu tiên
priority	sự ưu tế, quyền ưu tiên
prison	nhà tù
prisoner	tù nhân
privacy	riêng tư
private	cá nhân, riêng
privately	riêng tư, cá nhân
privilege	đặc quyền
prize	giải, giải thưởng
pro	pro
probable	có thể, có khả năng
probably	hầu như chắc chắn
problem	vấn đề, điều khó giải quyết
procedure	thủ tục
proceed	tiến lên, theo duổi, tiếp diễn
process	quá trình, sự tiến triển, quy trình, chế biến, gia công, xử lý
processing	chế biến
processor	bộ vi xử lý
proclaim	tuyên bố
produce	sản xuất, chế tạo
producer	nhà sản xuất
product	sản phẩm
production	sự sản xuất, chế tạo
productive	có năng suất
productivity	năng suất
profession	nghề, nghề nghiệp
professional	nghề, nghề nghiệp, chuyên nghiệp
professor	giáo sư, giảng viên
profile	hồ sơ
profit	thuận lợi, lợi ích, lợi nhuận
profound	thâm thúy
program	chương trình, lên chương trình
programme	chương trình
programming	lập trình
progress	sự tiến tới, sự tiến triển, tiến bộ, tiến triển, phát triển
progressive	cấp tiến
prohibit	cấm
project	đề án, dự án, kế hoạch, dự kiến, kế hoạch
projection	chiếu
prominent	nổi bật
promise	hứa, lời hứa
promising	hứa hẹn
promote	thăng chức, thăng cấp
promotion	sự thăng chức, sự thăng cấp
prompt	mau lẹ, nhanh chóng, xúi, giục, nhắc nhở
promptly	mau lẹ, ngay lập tức
pronounce	tuyên bố, thông báo, phát âm
pronunciation	sự phát âm
proof	chứng, chứng cớ, bằng chứng, sự kiểm chứng
proper	đúng, thích đáng, thích hợp
properly	một cách đúng đắn, một cách thích đáng
property	tài sản, của cải, đất đai, nhà cửa, bất động sản
proportion	sự cân xứng, sự cân đối
proposal	sự đề nghị, đề xuất
propose	đề nghị, đề xuất, đưa ra
proposed	đề xuất
prosecution	truy tố
prosecutor	công tố viên
prospect	viễn cảnh, toàn cảnh, triển vọng, mong chờ
protect	bảo vệ, che chở
protection	sự bảo vệ, sự che chở
protective	bảo vệ
protein	chất đạm
protest	sự phản đối, sự phản kháng, phản đối, phản kháng
protocol	giao thức
proud	tự hào, kiêu hãnh
proudly	một cách tự hào, một cách hãnh diện
prove	chứng tỏ, chứng minh
provide	chuẩn bị đầy đủ, dự phòng, cung cấp, chu cấp
provided	với điều kiện là, miễn là
provider	các nhà cung cấp
province	tỉnh
provision	điều khoản
provoke	kích động
psychological	tâm lý
psychologist	nhà tâm lý học
psychology	tâm lý học
public	chung, công cộng, công chúng, nhân dân
publication	sự công bố, sự xuất bản
publicity	sự công khai, sự quảng cáo
publicly	công khai, công cộng
publicyhouse	quán rượu, tiệm rượu
publish	công bố, ban bố, xuất bản
publisher	nhà xuất bản
publishing	công việc, nghề xuất bản
pull	lôi, kéo, giật, sự lôi kéo, sự giật
pulse	xung
pump	máy bơm
punch	đấm, thụi, quả đấm, cú thụi
punish	phạt, trừng phạt
punishment	sự trừng phạt, sự trừng trị
pupil	học sinh
purchase	sự mua, sự tậu, mua, sắm, tậu
pure	nguyên chất, tinh khiết, trong lành
purely	hoàn toàn, chỉ là
purple	tía, có màu tía, màu tía
purpose	mục đích, ý định
purse	cái ví
pursue	đuổi theo, đuổi bắt
pursuit	theo đuổi
push	xô đẩy, sự xô đẩy
put	đặt, để, cho vào
put  out	tắt, dập tắt
puzzle	câu đố
qualification	phẩm chất, năng lực, khả năng chuyên môn
qualified	đủ tư cách, điều kiện, khả năng
qualify	đủ khả năng, đủ tư cách, điều kiện
quality	chất lượng, phẩm chất
quantity	lượng, số lượng
quarter	4, 15 phút
quarterback	tiền vệ
queen	nữ hoàng
quest	nhiệm vụ
question	câu hỏi, hỏi, chất vấn
questionnaire	bảng câu hỏi
quick	nhanh
quickly	nhanh
quiet	lặng, yên lặng, yên tĩnh
quietly	lặng, yên lặng, yên tĩnh
quit	thoát, thoát ra
quite	hoàn toàn, hầu hết
quote	trích dẫn
rabbit	con thỏ
race	loài, chủng, giống, cuộc đua, đua
racial	chủng tộc
racing	cuộc đua
racism	chủ nghĩa phân biệt chủng tộc
rack	giá đỡ
radar	radar
radiation	sự bức xạ
radical	cấp tiến, căn nguyên
radio	sóng vô tuyến, radio
rage	giận dữ
rail	đường ray
railroad	đường sắt
railway	đường sắt
rain	mưa, cơn mưa, mưa
raise	nâng lên, đưa lên, ngẩng lên
rally	biểu tình
ranch	trang trại
random	ngẫu nhiên
range	dãy, hàng, loại, phạm vi, trình độ
rank	hàng, dãy, sắp xếp thành hàng, dãy
rape	hãm hiếp
rapid	nhanh, nhanh chóng
rapidly	nhanh, nhanh chóng
rare	hiếm, ít
rarely	hiếm khi, ít khi
rat	con chuột
rate	tỷ lệ, tốc độ
rather	thà.. còn hơn, thích... hơn
rather than	hơn là
rating	Xêp hạng
ratio	tỉ lệ
rational	hợp lý
raw	sống , thô, còn nguyên chất
re	lại
reach	đến, đi đến, tới
react	tác động trở lại, phản ứng
reaction	sự phản ứng, sự phản tác dụng
read	đọc
reader	người đọc, độc giả
readily	dễ dàng
reading	sự đọc
ready	sẵn sàng
real	thực, thực tế, có thật
realistic	hiện thực
reality	sự thật, thực tế, thực tại
realize	thực hiện, thực hành
really	thực, thực ra, thực sự
realm	cảnh giới
rear	phía sau, ở đằng sau, ở đằng sau
reason	lý do, lý lẽ
reasonable	có lý, hợp lý
reasonably	hợp lý
rebel	nổi loạn
rebuild	xây dựng lại
recall	gọi về, triệu hồi, nhặc lại, gợi lại
receipt	công thức, đơn thuốc
receive	nhận, lĩnh, thu
receiver	người nhận
recent	gần đây, mới đây
recently	gần đây, mới đây
reception	sự nhận, sự tiếp nhận, sự đón tiếp
recession	suy thoái kinh tế
recipe	công thức
recipient	người nhận
reckon	tính, đếm
recognition	sự công nhận, sự thừa nhận
recognize	nhận ra, nhận diện, công nhận, thừa nhận
recommend	giới thiệu, tiến cử, đề nghị, khuyên bảo
recommendation	sự giới thiệu
record	bản ghi, sự ghi, bản thu, sự thu, thu, ghi chép
recording	sự ghi, sự thu âm
recover	lấy lại, giành lại
recovery	phục hồi
recruit	tuyển dụng
red	đỏ, màu đỏ
reduce	giảm, giảm bớt
reduction	sự giảm giá, sự hạ giá
refer	tham khảo
refer to	xem, tham khảo, ám chỉ, nhắc đến
reference	sự tham khảo, hỏi ýe kiến
reflect	phản chiếu, phản hồi, phản ánh
reflection	sự phản chiếu
reform	cải cách, cải thiện, cải tạo, sự cải cách, sự cải thiện, cải tạo
refrigerator	tủ lạnh
refuge	nơi ẩn náu
refugee	người tị nạn
refusal	sự từ chối, sự khước từ
refuse	từ chối, khước từ
regain	giành lại
regard	nhìn, đánh giá, cái nhìn, sự quan tâm, sự chú ý
regarding	về, về việc, đối với
regardless	bất kể
regime	chế độ
region	vùng, miền
regional	vùng, địa phương
register	đăng ký, ghi vào sổ, sổ, sổ sách, máy ghi
regret	đáng tiếc, hối tiếc, lòng thương tiếc, sự hối tiếc
regular	thường xuyên, đều đặn
regularly	đều đặn, thường xuyên
regulate	quy định
regulation	sự điều chỉnh, điều lệ, quy tắc
regulator	người điều tiết
regulatory	quy định
rehabilitation	phục hồi chức năng
reinforce	củng cố
reject	không chấp nhận, loại bỏ, bác bỏ
relate	kể lại, thuật lại, liên hệ, liên quan
related	có liên quan, có quan hệ với ai, cái gì
relation	mối quan hệ, sự liên quan, liên lạc
relationship	mối quan hệ, mối liên lạc
relative	có liên quan đến, người có họ, đại từ quan hệ
relatively	có liên quan, có quan hệ
relax	giải trí, nghỉ ngơi
relaxed	thanh thản, thoải mái
relaxing	làm giảm, bớt căng thẳng
release	làm nhẹ, bớt, thả, phóng thích, phát hành, sự giải thoát, thoát
relevant	thích hợp, có liên quan
reliability	độ tin cậy
reliable	đáng tin cậy
relief	sự giảm nhẹ, sự làm cho khuây khỏa, sự trợ cấo, sự đền bù
relieve	giải tỏa
religion	tôn giáo
religious	tôn giáo
reluctant	lưỡng lự
rely	dựa
rely on	tin vào, tin cậy, tin tưởng vào
remain	còn lại, vẫn còn như cũ
remaining	còn lại
remains	đồ thừa, cái còn lại
remark	sự nhận xét, phê bình, sự để ý, chú ý, nhận xét, phê bình, để ý, chú ý
remarkable	đáng chú ý, đáng để ý, khác thường
remarkably	đáng chú ý, đáng để ý, khác thường
remember	nhớ, nhớ lại
remind	nhắc nhở, gợi nhớ
reminder	nhắc nhở
remote	xa, xa xôi, xa cách
removal	viêc di chuyển, việc dọn nhà, dời đi
remove	dời đi, di chuyển
render	render
rent	sự thuê mướn, cho thuê, thuê
rental	thuê
rented	được thuê, được mướn
repair	sửa chữa, chỉnh tu, sự sửa chữa, sự chỉnh tu
repeat	nhắc lại, lặp lại
repeated	được nhắc lại, được lặp lại
repeatedly	lặp đi lặp lại nhiều lần
replace	thay thế
replacement	thay thế
reply	sự trả lời, sự hồi âm, trả lời, hồi âm
report	báo cáo, tường trình, bản báo cáo, bản tường trình
reportedly	báo cáo
reporter	phóng viên
reporting	báo cáo
represent	miêu tả, hình dung, đại diện, thay mặt
representation	đại diện
representative	điều tiêu biểu, tượng trưng, mẫu, miêu tả, biểu hiện, đại diện, tượng trưng
reproduce	tái sản xuất
republic	nước cộng hòa
republican	nhà nước cộng hòa
reputation	sự nổi tiếng, nổi danh
request	lời thỉnh cầu, lời đề nghị, yêu cầu, thỉnh cầu, đề nghị, yêu cầu
require	đòi hỏi, yêu cầu, quy định
required	cần thiết
requirement	nhu cầu, sự đòi hỏi, luật lệ, thủ tục
rescue	giải thoát, cứu nguy, sự giải thoát, sự cứu nguy
research	sự nghiên cứu
researcher	nghiên cứu viên
resemble	giống
reservation	sự hạn chế, điều kiện hạn chế
reserve	dự trữ, để dành, đặt trước, đăng ký trước, sự dự trữ, sự để dành, sự đặt trước, sự đăng ký trước
residence	nơi cư trú
resident	người sinh sống, trú ngụ, khách trọ, có nhà ở, cư trú, thường trú
residential	nhà ở
resign	từ chức
resist	chống lại, phản đổi, kháng cự
resistance	sự chống lại, sự phản đối, sự kháng cự
resolution	độ phân giải
resolve	quyết định, kiên quyết
resort	kế sách, phương kế
resource	tài nguyên, kế sách, thủ đoạn
respect	sự kính trọng, sự lễ phép, tôn trọng, kính trọng, khâm phục
respectively	tương ứng
respond	hưởng ứng, phản ứng lại, trả lời
respondent	người trả lời
response	sự trả lời, câu trả lời, sự hưởng ứng, sự đáp lại
responsibility	trách nhiệm, sự chịu trách nhiệm
responsible	chịu trách nhiệm về, chịu trách nhiệm trước ai, gì
rest	sự nghỉ ngơi, lúc nghỉ, nghỉ, nghỉ ngơi
restaurant	nhà hàng ăn, hiệu ăn
restore	hoàn lại, trả lại, sửa chữa lại, phục hồi lại
restrict	hạn chế, giới hạn
restricted	bị hạn chế, có giới hạn, vùng cấm
restriction	sự hạn chế, sự giới hạn
result	kết quả, bởi, do.. mà ra, kết quả là...
resume	tiếp tục
retail	bán lẻ
retailer	nhà bán lẻ
retain	giữ lại, nhớ được
retire	rời bỏ, rút về, thôi, nghỉ việc, về hưu
retired	ẩn dật, hẻo lánh, đã về hưu, đã nghỉ việc
retirement	sự ẩn dật, nơi hẻo lánh, sự về hưu, sự nghỉ việc
retreat	rút lui
return	trở lại, trở về, sự trở lại, sự trở về
reveal	bộc lộ, biểu lộ, tiết lộ, phát hiện, khám phá
revelation	sự mặc khải
revenue	thu nhập
reverse	đảo, ngược lại, điều trái ngược, mặt trái
review	sự xem lại, sự xét lại, làm lại, xem xét lại
revise	đọc lại, xem lại, sửa lại, ôn lại
revision	sự xem lại, sự đọc lại, sự sửa lại, sự ôn lại
revolution	cuộc cách mạng
revolutionary	cách mạng
reward	sự thưởng, phần thưởng, thưởng, thưởng công
rhetoric	hùng biện
rhythm	nhịp điệu
rib	xương sườn
ribbon	ribbon
rice	gạo, thóc, cơm, cây lúa
rich	giàu, giàu có
rid	giải thoát
ride	đi, cưỡi , sự đi, đường đi
rider	người cưỡi ngựa, người đi xe đạp
ridge	cây rơm
ridiculous	buồn cười, lố bịch, lố lăng
riding	môn thể thao cưỡi ngựa, sự đi xe
rifle	súng trường
right	thẳng, phải, tốt, ngay, đúng, điều thiện, điều phải, tốt, bên phải
rightly	đúng, phải, có lý
rim	rim
ring	chiếc nhẫn, đeo nhẫn cho ai
riot	bạo loạn
rip	yên nghỉ
rise	sự lên, sự tăng lương, thăng cấp, dậy, đứng lên, mọc , thành đạt
risk	sự liều, mạo hiểm, liều
risky	rủi ro
ritual	lễ nghi
rival	đối thủ, địch thủ, đối địch, cạnh tranh
river	sông
road	con đường, đường phố
rob	cướp, lấy trộm
robot	robot
rock	đá
rocket	tên lửa
rod	gậy
role	vai , vai trò
roll	cuốn, cuộn, sự lăn tròn, lăn, cuốn, quấn, cuộn
rolling	lăn
roman	roman
romance	lãng mạn
romantic	lãng mạn
roof	mái nhà, nóc
room	phòng, buồng
root	gốc, rễ
rope	dây cáp, dây thừng, xâu, chuỗi
rose	bông hồng
rough	gồ ghề, lởm chởm
roughly	gồ ghề, lởm chởm
round	tròn, vòng quanh, xung quanh
rounded	bị làm thành tròn, phát triển đầy đủ
route	đường đi, lộ trình, tuyến đường
routine	thói thường, lệ thường, thủ tục, thường lệ, thông thường
routinely	thường
row	hàng
row name	hàng, dãy
royal	vua, nữ hoàng, hoàng gia
rub	cọ xát, xoa bóp, nghiền, tán
rubber	cao su
rubbish	vật vô giá trị, bỏ đi, rác rưởi
rude	bất lịch sự, thô lỗ, thô sơ, đơn giản
rudely	bất lịch sự, thô lỗ, thô sơ, đơn giản
ruin	làm hỏng, làm đổ nát, làm phá sản, sự hỏng, sự đổ nát, sự phá sản
ruined	bị hỏng, bị đổ nát, bị phá sản
rule	quy tắc, điều lệ, luật lệ, cai trị, chỉ huy, điều khiển
ruler	người cai trị, người trị vì, thước kẻ
ruling	phán quyết
rumor	tin đồn
rumour	tin đồn, lời đồn
run	chạy, sự chạy
runner	người chạy
running	sự chạy, cuộc chạy đua
rural	nông thôn, vùng nông thôn
rush	xông lên, lao vào, xô đẩy, sự xông lên, sự lao vào, sự xô đẩy
russian	người nga
sack	bào tải, đóng bao, bỏ vào bao
sacred	linh thiêng
sacrifice	sự hy sinh
sad	buồn, buồn bã
sadly	một cách buồn bã, đáng buồn là, không may mà
sadness	sự buồn rầu, sự buồn bã
safe	an toàn, chắc chắn, đáng tin
safely	an toàn, chắc chắn, đáng tin
safety	sự an toàn, sự chắc chăn
sail	đi tàu, thuyền, nhổ neo, buồm, cánh buồm, chuyến đi bằng thuyền buồm
sailing	sự đi thuyền
sailor	thủy thủ
sake	lợi ích
salad	sa lát , rau sống
salary	tiền lương
sale	việc bán hàng
sales	bán hàng
salmon	cá hồi
salt	muối
salty	chứ vị muối, có muối, mặn
same	đều đều, đơn điệu, cũng như thế, vẫn cái đó
sample	mẫu, hàng mẫu
sanction	(pl)  sự trừng phạt (pl)
sand	cát
sandwich	sandwich
satellite	vệ tinh
satisfaction	sự làm cho thỏa mãn, toại nguyện, sự trả nợ, bồi thường
satisfied	cảm thấy hài lòng, vừa ý, thoả mãn
satisfy	làm thỏa mãn, hài lòng, trả , chuộc tội
satisfying	đem lại sự thỏa mãn, làm thỏa mãn, làm vừa ý
saturday	thứ 7
sauce	nước xốt, nước chấm
save	cứu, lưu
saving	nói
say	nói
scale	vảy
scan	quét
scandal	vụ bê bối
scare	làm kinh hãi, sợ hãi, dọa, sự sợ hãi, sự kinh hoàng
scared	bị hoảng sợ, bị sợ hãi
scary	đáng sợ
scatter	tiêu tan
scenario	kịch bản
scene	cảnh, phong cảnh
scent	hương thơm
schedule	kế hoạch làm việc, bản liệt kê, lên thời khóa biểu, lên kế hoạch
scheme	sự sắp xếp, sự phối hợp, kế hoạch thực hiện, lược đồ, sơ đồ
scholar	học giả
scholarship	học bổng
school	đàn cá, bầy cá
science	khoa học, khoa học tự nhiên
scientific	khoa học, có tính khoa học
scientist	nhà khoa học
scissors	cái kéo
scope	phạm vi
score	điểm số, bản thắng, tỷ số, đạt được, thành công, cho điểm
scramble	tranh giành
scratch	cào, làm xước da, sự cào, sự trầy xước da
scream	gào thét, kêu lên, tiếng thét, tiếng kêu to
screen	màn che, màn ảnh, màn hình, phim ảnh nói chung
screening	kiểm tra
screw	đinh vít, đinh ốc, bắt vít, bắt ốc
script	kịch bản
sculpture	điêu khắc
sea	biển
seal	hải cẩu, săn hải cẩu
search	sự tìm kiếm, sự thăm dò, sự điều tra, tìm kiếm, thăm dò, điều tra
season	mùa
seat	ghế, chỗ ngồi
second	thứ hai, ở vị trí thứ 2, thứ nhì, người về nhì
secondary	trung học, thứ yếu
secret	bí mật, điều bí mật
secretary	thư ký
secretly	bí mật, riêng tư
section	mục, phần
sector	khu vực, lĩnh vực
secular	thế tục
secure	chắc chắn, đảm bảo, bảo đảm, giữ an ninh
security	sự an toàn, sự an ninh
see	nhìn, nhìn thấy, quan sát
seed	hạt, hạt giống
seek	tìm, tìm kiếm, theo đuổi
seem	hình như
seem linking	chọn lựa, chọn lọc
seemingly	có vẻ
segment	phần
seize	tịch thu
seldom	ít khi
select	lựa chọn
selected	đã chọn
selection	sự lựa chọn, sự chọc lọc
self	bản thân mình
self-esteem	lòng tự trọng
sell	bán
seller	người bán
seminar	hội thảo
senate	thượng nghi viện, ban giám hiệu
senator	thượng nghị sĩ
send	gửi, phái đi
senior	nhiều tuổi hơn, dành cho trẻ em trên 11t, người lớn tuổi hơn, sinh viên năm cuối trường trung học, cao đẳng
sensation	cảm giác
sense	giác quan, tri giác, cảm giác
sensible	có óc xét đoán, hiểu, nhận biết được
sensitive	dễ bị thương, dễ bị hỏng, dễ bị xúc phạm
sensitivity	nhạy cảm
sensor	cảm biến
sentence	câu
sentiment	tình cảm
separate	khác nhau, riêng biệt, làm rời, tách ra, chia tay
separated	ly thân
separately	không cùng nhau, thành người riêng, vật riêng
separation	sự chia cắt, phân ly, sự chia tay, ly thân
september	tháng 9
sequence	trình tự
series	loạt, dãy, chuỗi
serious	đứng đắn, nghiêm trang
seriously	đứng đắn, nghiêm trang
servant	người hầu, đầy tớ
serve	phục vụ, phụng sự
service	sự phục vụ, sự hầu hạ
serving	phục vụ
session	buổi họp, phiên họp, buổi, phiên
set	bộ, bọn, đám, lũ, đặt để, bố trí
set fire to	đốt cháy cái gì
setting	cài đặt
settle	giải quyết, dàn xếp, hòa giải, đặt, bố trí
settlement	giải quyết
seven	bảy
seventh	thứ bảy
several	vài
severe	khắt khe, gay gắt
severely	khắt khe, gay gắt
sew	may, khâu
sewing	sự khâu, sự may vá
sex	giới, giống
sexual	giới tính, các vấn đề sinh lý
sexuality	tình dục
sexually	giới tính, các vấn đề sinh lý
sexy	sexy
shade	bóng, bóng tối
shadow	bóng, bóng tối, bóng râm, bóng mát
shake	rung, lắc, giũ, sự rung, sự lắc, sự giũ
shall	sẽ
shall modal	dự đoán tương lai: sẽ
shallow	nông, cạn
shame	sự xấu hổ, thẹn thùng, sự ngượng
shape	hình, hình dạng, hình thù
shaped	có hình dáng được chỉ rõ
share	đóng góp, tham gia, chia sẻ, phần đóng góp, phần tham gia, phần chia sẻ
shared	chia sẻ
shareholder	cổ đông
shark	cá mập
sharp	sắc, nhọn, bén
sharply	sắc, nhọn, bén
shave	cạo
she	nó, bà ấy, chị ấy, cô ấy...
shed	đổ ra
sheep	con cừu
sheer	tuyệt
sheet	chăn, khăn trải giường, lá, tấm, phiến, tờ
shelf	kệ, ngăn, giá
shell	vỏ, mai, vẻ bề ngoài
shelter	sự nương tựa, sự che chở, sự ẩn náu, che chở, bảo vệ
shift	đổi chỗ, dời chỗ, chuyển, giao, sự thay đổi, sự luân phiên
shine	chiếu sáng, tỏa sáng
shiny	sáng chói, bóng
ship	tàu, tàu thủy
shirt	áo sơ mi
shit	dơ bẩn
shock	sự đụng chạm, va chạm, sự kích động, sự choáng, chạm mạnh, va mạnh, gây sốc
shocked	bị kích động, bị va chạm, bị sốc
shocking	gây ra căm phẫn, tồi tệ, gây kích động
shoe	giày
shoot	vụt qua, chạy qua, ném, phóng, bắn, đâm ra, trồi ra
shooting	sự bắn, sự phóng đi
shop	cửa hàng, đi mua hầng, đi chợ
shopping	sự mua sắm
shore	bờ biển
short	ngắn, cụt
short-term	thời gian ngắn
shortage	sự thiếu
shortly	trong thời gian ngắn, sớm
shorts	quần short
shot	đạn, viên đạn
should	nên
should modal	nên
shoulder	vai
shout	hò hét, reo hò, sự la hét, sự hò reo
shove	xô
show	biểu diễn, trưng bày, sự biểu diễn, sự bày tỏ
shower	vòi hoa sen, sự tắm vòi hoa sen
shrimp	con tôm
shrink	co lại
shrug	nhún vai
shut	đóng, khép, đậy, tính khép kín
shuttle	đưa đón
shy	nhút nhát, e thẹn
sibling	anh chị em ruột
sick	ốm, đau, bệnh
side	mặt, mặt phẳng
sidewalk	đường đi bộ
sideways	ngang, từ một bên, sang bên
sigh	thở dài
sight	cảnh đẹp, sự nhìn
sign	dấu, dấu hiệu, kí hiệu, đánh dấu, viết ký hiệu
signal	dấu hiệu, tín hiệu, ra hiệu, báo hiệu
signature	chữ ký
significance	tầm quan trọng
significant	nhiều ý nghĩa, quan trọng
significantly	đáng kể
silence	sự im lặng, sự yên tĩnh
silent	im lặng, yên tĩnh
silk	tơ , chỉ, lụa
silly	ngớ ngẩn, ngu ngốc, khờ dại
silver	bạc, đồng bạc, làm bằng bạc, trắng như bạc
similar	giống như, tương tự như
similarity	sự giống nhau
similarly	tương tự, giống nhau
simple	đơn, đơn giản, dễ dàng
simply	một cách dễ dàng, giản dị
simultaneously	đồng thời
sin	tội
since	từ, từ khi, từ khi, từ lúc đó, từ đó, từ lúc ấy
sincere	thật thà, thẳng thắng, chân thành
sincerely	một cách chân thành
sing	hát, ca hát
singer	ca sĩ
singing	sự hát, tiếng hát
single	đơn, đơn độc, đơn lẻ
sink	chìm, lún, đắm
sir	xưng hô lịch sự ngài, ông
sister	chị, em gái
sit	ngồi
sit down	ngồi xuống
site	chỗ, vị trí
situation	hoàn cảnh, địa thế, vị trí
six	sáu
sixth	thứ sáu
size	cỡ
sized	đã được định cỡ
ski	trượt tuyết
skilful	tài giỏi, khéo tay
skilfully	tài giỏi, khéo tay
skill	kỹ năng, kỹ sảo
skilled	có kỹ năng, có kỹ sảo, khẻo tay, có kinh nghiệm,, lành nghề
skin	da, vỏ
skip	bỏ qua
skirt	váy, đầm
skull	sọ
sky	trời, bầu trời
slam	sập
slap	tát
slave	nô lệ
slavery	chế độ nô lệ
sleep	ngủ, giấc ngủ
sleeve	tay áo, ống tay
slice	miếng, lát mỏng, cắt ra thành miếng mỏng, lát mỏng
slide	trượtc, chuyển động nhẹ, lướt qua
slight	mỏng manh, thon, gầy
slightly	mảnh khảnh, mỏng manh, yếu ớt
slip	trượt, tuột, trôi qua, chạy qua
slope	dốc, đường dốc, độ dốc, nghiêng, dốc
slot	khe
slow	chậm, chậm chạp
slowly	một cách chậm chạp, chậm dần
small	nhỏ, bé
smart	mạnh, ác liệt
smash	đập, vỡ tan thành mảnh, sự đập, vỡ tàn thành mảnh
smell	ngửi, sự ngửi, khứu giác
smile	cười, mỉm cười, nụ cười, vẻ tươi cười
smoke	khói, hơi thuốc, hút thuốc, bốc khói, hơi
smoking	sự hút thuốc
smooth	nhẵn, trơn, mượt mà
smoothly	một cách êm ả, trôi chảy
snake	con rắn, người nham hiểm, xảo trá
snap	chụp nhanh
sneak	sneak
snow	tuyết, tuyết rơi
so	như vậy, như thế, vì thế, vì vậy, vì thế cho nên
so that	để, để cho, để mà
so-called	cái gọi là
soak	ngâm
soap	xà phòng
soar	bay lên
soccer	bóng đá
social	có tính xã hội
socially	có tính xã hội
society	xã hội
sock	tất ngăns, miếng lót giày
sodium	natri
sofa	ghế sô pha
soft	mềm, dẻo
soften	làm mềm
softly	một cách mềm dẻo
software	phần mềm
soil	đất trồng, vết bẩn
solar	hệ mặt trời
soldier	lính, quân nhân
sole	duy nhất
solely	chỉ
solid	rắn, thể rắn, chất rắnh
solution	sự giải quyết, giải pháp
solve	giải, giải thích, giải quyết
some	một it, một vài
somebody	người nào đó
someday	một ngày nào đó
somehow	không biết làm sao, bằng cách này hay cách khác
someone	người nào
something	một điều gì đó, một việc gì đó, một cái gì đó
sometime	thỉnh thoảng
sometimes	thỉnh thoảng, đôi khi
somewhat	đến mức độ nào đó, hơi, một chút
somewhere	nơi nào đó. đâu đó
son	con trai
song	bài hát
soon	sớm, chẳng bao lâu nữa
sophisticated	tinh vi
sore	đau, nhức
sorry	xin lỗi, lấy làm tiếc, lấy làm buồn
sort	thứ, hạng loại, lựa chọn, sắp xếp, phân loại
soul	tâm hồn, tâm trí, linh hồn
sound	âm thanh, nghe
soup	xúp, canh, cháo
sour	chua, có vị giấm
source	nguồn
south	phương nam, hướng nam, ở phía nam, hướng về phía nam
southeast	Đông nam
southern	thuộc phương nam
southwest	tây nam
sovereignty	chủ quyền
soviet	liên Xô
space	khoảng trống, khoảng cách
spanish	người tây ban nha
spare	thừa thãi, dự trữ, rộng rãi, đồ dự trữ, đồ dự phòng
spark	tia lửa
speak	nói
speaker	người nói, người diễn thuyết
special	đặc biệt, riêng biệt
specialist	chuyên gia, chuyên viên
specialize	chuyên môn hóa
specially	đặc biệt, riêng biệt
specialty	chuyên môn
species	loài
specific	đặc trưng, riêng biệt
specifically	đặc trưng, riêng biệt
specify	chỉ định
spectacular	đẹp mắt
spectrum	quang phổ
speculate	suy đoán
speculation	suy đoán
speech	sự nói, khả năng nói, lời nói, cách nói, bài nói
speed	tốc độ, vận tốc
spell	đánh vần, sự thu hút, sự quyến rũ, say mê
spelling	sự viết chính tả
spend	tiêu, xài
spending	chi tiêu
sphere	quả cầu
spice	gia vị
spicy	có gia vị
spider	con nhện
spill	tràn
spin	quay, quay tròn
spine	xương sống
spirit	tinh thần, tâm hồn, linh hồn
spiritual	tinh thần, linh hồn
spit	nhổ
spite	sự giận, sự hận thù,
split	chẻ, tách, chia ra, sự chẻ, sự tách, sự chia ra
spoil	cướp, cướp đọat
spoken	nói theo 1 cách nào đó
spokesman	người phát ngôn
sponsor	nhà tài trợ
spoon	cái thìa
sport	thể thao
spot	dấu, đốm, vết
spouse	vợ / chồng
spray	máy, ống, bình phụt, bơm, phun, bơm, phun, xịt
spread	trải, căng ra, bày ra, truyền bá
spring	mùa xuân
sprinkle	rắc
spy	gián điệp
squad	đội hình
square	vuông, vuông vắn, dạng hình vuông, hình vuông
squeeze	ép, vắt, xiết, sự ép, sự vắt, sự xiết
stability	sự ổn định
stable	ổn định, bình tĩnh, vững vàng, chuồng ngưa
stack	cây rơm
stadium	sân vận động
staff	gậy
stage	tầng, bệ
stair	bậc thang
stake	cổ phần
stamp	tem, dán tem
stance	lập trường
stand	đứng, sự đứng
stand up	đứng đậy
standard	tiêu chuẩn, chuẩn, mãu, làm tiêu chuẩn, phù hợp với tiêu chuẩn
standing	đứng
star	ngôi sao, dán sao, trang trí hình sao, đánh dấu sao
stare	nhìm chằm chằm, sự nhìn chằm chằm
start	bắt đầu, khởi động, sự bắt đầu, sự khởi đầu, khởi hành
starter	bắt đầu
starting	bắt đầu
state	nhà nước, quốc gia, chính quyền,  nhà nước, có liên quan đến nhà nước, phát biểu, tuyên bố
statement	sự bày tỏ, sự phát biểu, sự tuyên bố, sự trình bày
station	trạm, điểm, đồn
statistical	thống kê
statistics	số liệu thống kê
statue	tượng
status	tình trạng
statute	đạo luật
stay	ở lại, lưu lại, sự ở lại, sự lưu lại
steadily	vững chắc, vững vàng, kiên định
steady	vững chắc, vững vàng, kiến định
steak	miếng bò hầm
steal	ăn cắp, ăn trộm
steam	hơi nước
steel	thép, ngành thép
steep	dốc, dốc đứng
steeply	dốc, cheo leo
steer	lái
stem	thân cây
step	bước, bước, bước đi
stereotype	khuôn mẫu
stick	đâm, thọc, chọc, cắm, dính, cái gậy, qua củi, cán
stick out	đòi, đạt được cái gì
sticky	dính, nhớt
stiff	cứng, cứng rắn, kiên quyết
stiffly	cứng, cứng rắn, kiên quyết
still	đứng yên, vẫn, vẫn còn
stimulate	kích thích
stimulus	kích thích kinh tế
sting	châm, chích, đốt, ngòi, vòi , sự châm, chích..
stir	khuấy, đảo
stock	kho sự trữ, hàng dự trữ, vốn
stomach	dạ dày
stone	đá
stop	dừng, ngừng, nghỉ, thôi, sự dừng, sự ngừng, sự đỗ lại
storage	lưu trữ
store	cửa hàng, kho hàng, tích trữ, cho vào kho
storm	cơn giông, bão
story	chuyện, câu chuyện
stove	bếp lò, lò sưởi
straight	thẳng, không cong
straighten	làm thẳng
strain	sự căng thẳng, sự căng
strange	xa lạ, chưa quen
strangely	lạ, xa lạ, chưa quen
stranger	người lạ
strategic	chiến lược
strategy	chiến lược
straw	rơm rạ
streak	streak
stream	dòng suối
street	phố, đườmg phố
strength	sức mạnh, sức khỏe
strengthen	củng cố
stress	sự căng thẳng, căng thẳng, ép, làm căng
stressed	bị căng thẳng, bị ép, bị căng
stretch	căng ra, duỗi ra, kéo dài ra
strict	nghiêm khắc, chặt chẽ,, khắt khe
strictly	một cách nghiêm khắc
strike	đánh, đập, bãi công, đình công, cuộc bãi công, cuộc đình công
striking	nổi bật, gây ấn tượng
string	dây, sợi dây
strip	cởi, lột , sự cởi quần áo
stripe	sọc, vằn, viền
striped	có sọc, có vằn
stroke	cú đánh, cú đòn, cái vuốt ve, sự vuốt ve, vuốt ve
strong	khỏe, mạnh, bền, vững, chắc chắn
strongly	khỏe, chắc chắn
structural	cấu trúc
structure	kết cấu, cấu trúc
struggle	đấu tranh, cuộc đấu tranh, cuộc chiến đấu
student	sinh viên
studio	xưởng phim, trường quay, phòng thu
study	sự học tập, sự nghiên cứu, học tập, nghiên cứu
stuff	chất liệu, chất
stumble	tình cờ gặp
stupid	ngu ngốc, ngu đần, ngớ ngẩn
style	phong cách, kiểu, mẫu, loại
subject	chủ đề, đề tài, chủ ngữ
submit	đệ trình
subsequent	sau đó
subsidy	trợ cấp
substance	chất liệu, bản chất, nội dung
substantial	thực tế, đáng kể, quan trọng
substantially	về thực chất, về căn bản
substitute	người, vật thay thế, thay thế
subtle	tế nhị
suburb	ngoại ô
suburban	ngoại ô
succeed	nối tiếp, kế tiếp, kế nghiệp, kế vị
success	sự thành công,, sự thành đạt
successful	thành công, thắng lợi, thành đạt
successfully	thành công, thắng lợi, thành đạt
such	như thế, như vậy, như là
such as	đến nỗi, đến mức
suck	bú, hút, hấp thụ, tiếp thu
sudden	thình lình, đột ngột
suddenly	thình lình, đột ngột
sue	kiện
suffer	chịu đựng, chịu thiệt hại, đau khổ
suffering	sự đau đớn, sự đau khổ
sufficient	đủ, thích đáng
sufficiently	đủ, thích đáng
sugar	đường
suggest	đề nghị, đề xuất, gợi
suggestion	sự đề nghị, sự đề xuất, sự khêu gợi
suicide	tự tử
suit	bộ com lê, trang phục, thích hợp, quen, hợp với
suitable	hợp, phù hợp, thích hợp với
suitcase	va li
suite	suite
suited	hợp, phù hợp, thích hợp với
sum	tổng, toàn bộ
summary	bản tóm tắt
summer	mùa hè
summit	hội nghị thượng đỉnh
sun	mặt trời
sunday	chủ nhật
sunlight	ánh sáng mặt trời
sunny	nắng
super	siêu
superior	cao, chất lượng cao
supermarket	siêu thị
supervisor	người giám sát
supplier	nhà cung cấp
supply	sự cung cấp, nguồn cung cấp, cung cấp, đáp ứng, tiếp tế
support	sự chống đỡ, sự ủng hộ, chống đỡ, ủng hộ
supporter	vật chống đỡ, người cổ vũ, người ủng hộ
supportive	hỗ trợ
suppose	cho rằng, tin rằng, nghĩ rằng
supposed	giả định
supposedly	được cho là
supreme	tối cao
sure	chắc chắn, xác thực
surely	chắc chắn
surface	mặt, bề mặt
surgeon	bác sĩ phẫu thuật
surgery	phẫu thuật
surname	họ
surprise	sự ngạc nhiên, sự bất ngờ, làm ngạc nhiên, gây bất ngờ
surprised	ngạc nhiên
surprising	làm ngạc nhiên, làm bất ngờ
surprisingly	làm ngạc nhiên, làm bất ngờ
surround	vây quanh, bao quanh
surrounding	sự vây quanh, sự bao quanh
surroundings	vùng xung quanh, môi trường xung quanh
surveillance	giám sát
survey	sự nhìn chung, sự khảo sát, quan sát, nhìn chung, khảo sát, nghiên cứu
survival	sự sống còn
survive	sống lâu hơn, tiếp tục sống, sống sót
survivor	người sống sót
suspect	nghi ngờ, hoài nghi, người khả nghi, người bị tình nghi
suspend	đình chỉ
suspicion	sự nghi ngờ, sự ngờ vực
suspicious	có sự nghi ngờ, tỏ ra nghi ngờ, khả nghi
sustain	duy trì
sustainable	bền vững
swallow	nuốt, nuốt chửng
swear	chửi rủa, nguyền rủa, thề, hứa
swearing	lời thề, lời nguyền rủa, lời thề hứa
sweat	mồ hôi, đổ mồ hôi
sweater	người ra mồ hôi,, kẻ bóc lột lao động
sweep	quét
sweet	ngọt, có vị ngọt, sự ngọt bùi, đồ ngọt
swell	phồng, sưng lên
swelling	sự sưng lên, sự phồng ra
swim	bơi lội
swimming	sự bơi lội
swimming pool	bể nước
swing	sự đu đưa, lúc lắc, đánh đu, đu đưa, lúc lắc
switch	công tắc, roi, tắt, bật, đánh bằng gậy, roi
switch  off	ngắt điện
switch  on	bật điện
swollen	sưng phồng, phình căng
swollen swell	phồng lên, sưng lên
sword	thanh kiếm
symbol	biểu tượng, ký hiệu
symbolic	tượng trưng
sympathetic	đồng cảm, đáng mến, dễ thương
sympathy	sự đồng cảm, sự đồng ý
symptom	triệu chứng
syndrome	hội chứng
system	hệ thống, chế độ
t-shirt	Áo thun
table	cái bàn
tablespoon	muỗng canh
tablet	tấm, bản, thẻ phiến
tackle	giải quyết, khắc phục, bàn thảo, đồ dùng, dụng cụ
tactic	chiến thuật
tag	nhãn
tail	đuôi, đoạn cuối
take	sự cầm nắm, sự lấy
take  over	chở, chuyển cái gì, tiếp quản, kế tục cái gì
take advantage of	lợi dụng
take notice of	chú ý
take place	xảy ra, được cử hành, được tổ chức
take sth off	cởi, bỏ cái gì, lấy đi cái gì
tale	câu chuyện
talent	năng lực
talented	có tài
talk	nói chuyện, trò chuyện, cuộc trò chuyện, cuộc thảo luận
tall	cao
tank	thùng, két, bể
tap	mở vòi, đóng vồi, vòi, khóa
tape	băng, băng ghi âm, dải, dây
target	bia, mục tiêu, đích
task	nhiệm vụ, nghĩa vụ, bài tập, công tác, công việc
taste	vị, vị giác, nếm
tax	thuế, đánh thuế
taxi	xe tắc xi
taxpayer	người nộp thuế
tea	cây chè, trà, chè
teach	dạy
teacher	giáo viên
teaching	sự dạy, công việc dạy học
team	đội, nhóm
teammate	đồng đội
tear	xé, làm rắch, chỗ rách, miếng xe, nước mắt
teaspoon	muỗng cà phê
technical	kỹ thuật, chuyên môn
technician	kỹ thuật viên
technique	kỹ sảo, kỹ thuật, phương pháp kỹ thuật
technological	công nghệ
technology	kỹ thuật học, công nghệ học
teen	thiếu niên
teenage	thiếu niên
teenager	thiếu niên
telephone	máy điện thoại, gọi điện thoại
telescope	kính viễn vọng
television	vô tuyến truyền hình
tell	nói, nói với
temperature	nhiệt độ
temple	ngôi đền
temporarily	tạm
temporary	tạm thời, nhất thời
ten	mười
tend	trông nom, chăm sóc, giữ gìn, hầu hạ
tendency	xu hướng, chiều hướng, khuynh hướng
tender	đấu thầu
tennis	quần vợt
tension	sự căng, độ căng, tình trạng căng
tent	lều, rạp
term	giới hạn, kỳ hạn, khóa, kỳ học
terms	điều kiện
terrain	địa hình
terrible	khủng khiếp, ghê sợ
terribly	tồi tệ, không chịu nổi
terrific	khủng khiếp
territory	lãnh thổ
terror	khủng bố
terrorism	khủng bố
terrorist	khủng bố
test	bài kiểm tra, sự thử nghiệm, xét nghiệm, kiểm tra, xét nghiệm, thử nghiệm
testify	làm chứng
testimony	lời khai
testing	thử nghiệm
text	nguyên văn, bản văn, chủ đề, đề tì
textbook	sách giáo khoa
texture	kết cấu
than	hơn
thank	cám ơn
thank you	cảm ơn bạn
thanks	sự cảm ơn, lời cảm ơn
thanksgiving	lễ tạ ơn
that	người ấy, đó, vật ấy, đó, rằng, là
the	các
the definite article	cái, con, người, ấy này....
the rest	vật, cái còn lại, những người, cái khác
theater	rạp hát
theatre	rạp hát, nhà hát
their	của chúng, của chúng nó, của họ
theirs	của chúng, của chúng nó, của họ
them	chúng, chúng nó, họ
theme	đề tài, chủ đề
themselves	tự chúng, tự họ, tự
then	khi đó, lúc đó, tiếp đó
theological	thần học
theology	thần học
theoretical	lý thuyết
theory	lý thuyết, học thuyết
therapist	nhà trị liệu
therapy	trị liệu
there	ở nơi đó, tại nơi đó
thereby	bằng cách ấy
therefore	bởi vậy, cho nên, vì thế
these	những
they	chúng, chúng nó, họ, những cái ấy
thick	dày, đậm
thickly	dày, dày đặc, thành lớp dày
thickness	tính chất dày, độ dày, bề dày
thief	kẻ trộm, kẻ cắp
thigh	đùi
thin	mỏng, mảnh
thing	cái, đồ, vật
think	nghĩ, suy nghĩ
thinking	sự suy nghĩ, ý nghĩ
third	thứ ba
thirsty	khát, cảm thấy khát
thirty	ba mươi
this	cái này, điều này, việc này
thorough	cẩn thận, kỹ lưỡng
thoroughly	kỹ lưỡng, thấu đáo, triệt để
those	những, cái đó
though	dù, dù cho, mặc dù, mặc dù, tuy nhiên, tuy vậy
thought	sự suy nghĩ, khả năng suy nghĩ, ý nghĩ, tư tưởng, tư duy
thousand	nghìn
thread	chỉ, sợi chỉ, sợi dây
threat	sự đe dọa, lời đe dọa
threaten	dọa, đe dọa
threatening	sự đe dọa, sự hăm dọa
three	số ba
threshold	ngưỡng
thrive	phát đạt
throat	cổ, cổ họng
through	qua, xuyên qua
throughout	khắp, suốt
throw	ném, vứt, quăng
thumb	ngón tay cái
thursday	thứ 5
thus	như vậy, như thế, do đó
ticket	vé
tide	thủy triều
tidy	sạch sẽ, ngăn nắp, gọn gàng, làm cho sạch sẽ, gọn gàng, ngăn nắp
tie	buộc, cột, trói, dây buộc, daay trói, dây giày
tie sth up	có quan hệ mật thiết, gắn chặt
tight	kín, chặt, chật
tighten	thắt chặt
tightly	chặc chẽ, sít sao
tile	ngói
till	cho đến
till until	cho đến khi, tới lúc mà
timber	gỗ
time	thời gian, thì giờ
timetable	kế hoạch làm việc, thời gian biểu
timing	thời gian
tin	thiếc
tiny	rất nhỏ, nhỏ xíu
tip	đầu, mút, đỉnh, chóp, bịt đầu, lắp đầu vào
tire	làm mệt mỏi, trở nên mệt nhọc, lốp, vỏ xe
tired	mệt, muốn ngủ, nhàm chán
tiring	sự mệt mỏi, sự mệt nhọc
tissue	mô
title	đầu đề, tiêu đề, tước vị, tư cách
to	theo hướng, tới
tobacco	thuốc lá
today	vào ngày này, hôm nay, ngày nay
toe	ngón chân
together	cùng nhau, cùng với
toilet	nhà vệ sinh, sự trang điểm
tolerance	lòng khoan dung
tolerate	tha thứ
toll	số điện thoại
tomato	cà chua
tomorrow	vào ngày mai, ngày mai
ton	tấn
tone	tiếng, giọng
tongue	lưỡi
tonight	vào đêm nay, vào tối nay, đêm nay, tối nay
tonne	tấn
too	cũng
tool	dụng cụ, đồ dùng
tooth	răng
top	chóp, đỉnh, đứng đầu, trên hết
topic	đề tài, chủ đề
toss	quăng
total	tổng cộng, toàn bộ, tổng số, toàn bộ số lượng
totally	hoàn toàn
touch	sờ, mó, tiếp xúc, sự sờ, sự mó, sự tiếp xúc
touchdown	đụng
tough	chắc, bền, dai
tour	cuộc đo du lịch, cuộc đi dạo, chuyến du lịch, đi du lịch
tourism	du lịch
tourist	khách du lịch
tournament	giải đấu
toward	đối với
towards	theo hướng, về hướng
towel	khăn tắm, khăn lau
tower	tháp
town	thị trấn, thị xã, thành phố nhỏ
toxic	chất độc
toy	đồ chơi, đồ trang trí, thể loại đồ chơi
trace	phát hiện, tìm thấy, vạch, chỉ ra, phác họa, dấu, vết, một chút
track	phần của đĩa, đường mòn, đường đua
trade	thương mại, buôn bán, buôn bán, trao đổi
trading	sự kinh doanh, việc mua bán
tradition	truyền thống
traditional	theo truyền thống, theo lối cổ
traditionally	truyền thống, là truyền thống
traffic	sự đi lại, sự giao thông, sự chuyển động
tragedy	bi kịch
tragic	bi kịch
trail	đường mòn
trailer	trailer
train	xe lửa, tàu hỏa, dạy, rèn luyện, đào tạo
trainer	người huấn luyện
training	sự dạy dỗ, sự huấn luyện, sự đào tạo
trait	đặc điểm
transaction	giao dịch
transfer	dời, di chuyển, sự di chuyển, sự dời chỗ
transform	thay đổi, biến đổi
transformation	chuyển đổi
transit	quá cảnh
transition	quá trình chuyển đổi
translate	dịch, biên dịch, phiên dịch
translation	sự dịch
transmission	truyền tải
transmit	chuyển giao
transparent	trong suốt, dễ hiểu, sáng sủa
transport	chuyên chở, vận tải
transportation	vận chuyển
trap	đồ đạc, hành lý, bẫy, cạm bãy, bẫy, giữ, chặn lại
trash	rác
trauma	chấn thương
travel	đi lại, đi du lịch, di chuyển, sự đi, những chuyến đi
traveler	du khách
traveller	người đi, lữ khách
tray	cái mâm
treasure	kho báu
treat	đối xử, đối đãi, cư xử
treatment	sự đối xử, sự cư xử
treaty	hiệp ước
tree	cây
tremendous	to lớn
trend	phương hướng, xu hướng, chiều hướng
trial	sự thử nghiệm, cuộc thử nghiệm
triangle	hình tam giác
tribal	bộ lạc
tribe	bộ lạc
trick	mưu mẹo, thủ đoạn, trò lừa gatj, lừa, lừa gạt
trigger	cò súng
trim	cắt tỉa
trip	cuộc dạo chơi, cuộc du ngoạn, đi dạo, du ngoạn
triumph	triumph
troop	(pl)  quân (pl)
tropical	nhiệt đới
trouble	điều lo lắng, điều muộn phiền
troubled	gặp rắc rối
trousers	quần
truck	rau quả tươi
true	đúng, thật
truly	đúng sự thật, đích thực, thực sự
trunk	thân cây
trust	niềm tin, sự phó thác, tin, tin cậy, phó thác
truth	sự thật
try	thử, cố gắng
tube	ống, tuýp
tuck	tuck
tuesday	thứ 3
tumor	khối u
tune	điệu, giai điệu, lên dây, so dây
tunnel	đường hầm, hang
turkey	gà tây
turn	quay, xoay, vặn, sự quay, vòng quay
tv	tv
tv television	vô tuyến truyền hình
twelve	mười hai
twentieth	hai mươi
twenty	hai mươi
twice	hai lần
twin	sinh đôi, tạo thành cặp, cặp song sinh
twist	xoắn, cuộn, quắn, sự xoắn, vòng xoắn
twisted	được xoắn, được cuộn
two	hai
two-thirds	hai phần ba
type	loại, kiểu, mẫu, phân loại, xếp loại
typical	tiêu biểu, điển hình, đặc trưng
typically	điển hình, tiêu biểu
tyre	lốp, vỏ xe
ugly	xấu xí, xấu xa
uh	uh
ultimate	cuối cùng, sau cùng
ultimately	cuối cùng, sau cùng
umbrella	ô, dù
unable	không có năng lực, không có tài
unable able	không thể, không có khẳ năng
unacceptable	không thể chấp nhận, không tán thành, không tha thứ, không chịu nổi
unacceptable acceptable	không thể chấp nhận
uncertain	thiếu chính xác, không chắc chắn
uncertain certain	không chắc chắn, khôn biết rõ ràng
uncertainty	tính không chắc chắn
uncle	chú, bác
uncomfortable	bất tiện, khó chịu, không thoải mái
uncomfortable comfortable	bất tiện, không tiện lợi
unconscious	bất tỉnh, không có ý thức, không biết rõ
unconscious conscious	bất tỉnh, ngất đi
uncontrolled	không bị điều khiển, không bị kiểm tra, không bị hạn
uncontrolled control	không bị kiềm chế, không bị kiểm tra
uncover	khám phá
under	dưới, ở dưới, ở phía dưới, về phía dưới
undergo	trải qua
undergraduate	đại học
underground	dưới mặt đất, ngầm dưới đất, ngầm
underlying	cơ bản
undermine	phá hoại
underneath	dưới, bên dưới
understand	hiểu, nhận thức
understanding	trí tuệ, sự hiểu biết
undertake	thực hiện
underwater	ở dưới mặt nước, dưới mặt nước
underwear	quần lót
undo	tháo, gỡ, xóa bỏ, hủy bỏ
undo do	tháo, gỡ, xóa, hủy bỏ
unemployed	thất nghiệp, không dùng, không sử dụng được
unemployed employ	không dùng, thất nghiệp
unemployment	sự thất nghiệp, nạn thất nghiệp
unemployment employment	sự thất nghiệp, tình trạng thất nghiệp
unexpected	bất ngờ, gây ngạc nhiên
unexpected, unexpectedly	bất ngờ, đột ngột, gây ngạc nhiên
unexpectedly	bất ngờ, gây ngạc nhiên
unfair	gian lận, không công bằng, bất lợi
unfair, unfairly fair	không đúng, không công bằng, gian lận
unfairly	gian lận, không công bằng, bất lợi
unfold	mở ra
unfortunate	không may, rủi ro, bất hạnh
unfortunately	một cách đáng tiếc, một cách không may
unfriendly	không thân thiện, không có thiện cảm
unfriendly friendly	đối địch, không thân thiện
unhappiness	nỗi buồn, sự bất hạnh
unhappiness happiness	sự buồn, nỗi buồn
unhappy	buồn rầu, khốn khổ
unhappy happy	buồn rầu, khổ sở
uniform	đồng phục, đều, giống nhau, đồng dạng
unimportant	khônh quan trọng, không trọng đại
unimportant important	không quan trọng
union	liên hiệp, sự đoàn kết, sự hiệp nhất
unique	độc nhất vô nhị
unit	liên kết, hợp nhất, hợp lại, kết thân
unite	thống nhất
united	liên minh, đoàn kết, chung, thống nhất
unity	thống nhất
universal	phổ cập
universe	vũ trụ
university	trường đại học
unkind	độc ác, tàn nhẫn
unkind kind	không tử tế, không tốt
unknown	không biết
unknown know	không biết, không được nhận ra
unless	trừ phi, trừ khi, nếu không
unlike	khác, không giống
unlike like	không giống, khác
unlikely	không thể xảy ra, không chắc xảy ra
unlikely likely	không có thể xảy ra, không chắc chắn, không có thực
unload	cất gánh nặng, dỡ hàng
unload load	tháo, dỡ
unlucky	không gặp may, bất hạnh
unlucky lucky	không gặp may, không may mắn
unnecessary	không cần thiết, không mong muốn
unnecessary necessary	không cần thiết, không mong muốn
unpleasant	không dễ chịu, khó chịu, khó ưa
unpleasant pleasant	không dễ chịu, khó chịu
unprecedented	chưa từng có
unreasonable	vô lý
unreasonable reasonable	vô lý, vượt quá giới hạn của cái hợp lý
unsteady	không chắc, không ổn định
unsteady steady	không đúng mực, không vững, không chắc
unsuccessful	không thành công, thất bại
unsuccessful successful	không thành công, không thành đạt
untidy	không gọn gàng, không ngăn nắp, lộn xộn
untidy tidy	không gọn gàng, không ngăn nắp, lộn xộn
until	trước khi, cho đến khi
unusual	hiếm, khác thường, đáng chú ý
unusual, unusually usual	hiếm, khác thường
unusually	cực kỳ, khác thường
unwilling	không sẵn lòng, miễn cưỡng
unwilling, unwillingly willing	không muốn, không có ý định
unwillingly	không sẵn lòng, miễn cưỡng
up	ở trên, lên trên, lên
update	cập nhật
upon	trên, ở trên
upper	cao hơn
upset	làm đổ, đánh đổ
upsetting	tính đánh đổ, làm đổ
upside down	lộn ngược
upstairs	ở tên gác, cư ngụ ở tầng gác, tầng trên, gác
upward	lên, hướng lên, đi lên
urban	thành phố, khu vực
urge	thúc, giục, giục giã, sự thúc đẩy, sự thôi thúc
urgent	gấp, khẩn cấp
us	chúng tôi, chúng ta, tôi và anh
use	sử dụng, dùng, sự dùng, sự sử dụng
used	đã dùng, đã sử dụng
used to modal	đã quen dùng
used to sth/to doing sth	sử dụng cái gì, sử dụng để làm cái gì
useful	hữu ích, giúp ích
useless	vô ích, vô dụng
user	người dùng, người sử dụng
usual	thông thường, thường dùng
usually	thường thường
utility	tiện ích
utilize	sử dụng
vacation	kỳ nghỉ hè, kỳ nghỉ lễ, ngày nghỉ, ngày lễ
vaccine	vắc-xin
vacuum	khoảng chân không
valid	chắc chắn, hiệu quả, hợp lý
validity	hiệu lực
valley	thung lũng
valuable	có giá trị lớn, đáng giá
value	giá trị, ước tính, định giá
van	tiền đội, quân tiên phong, xe tải
vanish	biến mất
variable	biến
variation	sự biến đổi, sự thay đổi mức độ, sự khác nhau
varied	thuộc nhiều loại khác nhau, những vẻ đa dạng
variety	sự đa dạng, trạng thái khác nhau
various	khác nhau, thuộc về nhiều loại
vary	thay đổi, làm cho khác nhau, biến đổi
vast	rộng lớn, mênh mông
vegetable	rau, thực vật
vehicle	xe cộ
vendor	nhà cung cấp
venture	sự án kinh doanh, công việc kinh doanh, liều, mạo hiểm, cả gan
verbal	lời nói
verdict	bản án
version	bản dịch sang một ngôn ngữ khác
versus	đấu với
vertical	thẳng đứng, đứng
very	rất, lắm
vessel	tàu
veteran	cựu chiến binh
via	qua, theo đường
victim	nạn nhân
victory	chiến thắng
video	video
view	sự nhìn, tầm nhìn, nhìn thấy, xem, quan sát
viewer	người xem
village	làng, xã
violate	xâm phạm
violation	sự vi phạm
violence	sự ác liệt, sự dữ dội, bạo lực
violent	mãnh liệt, mạnh mẽ, hung dữ
violently	mãnh liệt, dữ dội
virtual	ảo
virtually	thực sự, hầu như, gần như
virtue	Đức hạnh
virus	vi rút
visible	hữu hình, thấy được
vision	sự nhìn, thị lực
visit	đi thăm hỏi, đến chơi, tham quan, sự đi thăm, sự thăm viếng
visitor	khách, du khách
visual	trực quan
vital	sự sống, cần cho sự sống
vitamin	vitamin
vocabulary	từ vựng
vocal	tiếng hát
voice	tiếng, giọng nói
volume	thế tích, quyển, tập
voluntary	tình nguyện
volunteer	tình nguyện
vote	sự bỏ phiếu, sự bầu cử, bỏ phiếu, bầu cử
voter	cử tri
voting	bầu cử
vs	vs
vulnerable	dễ bị tổn thương
wage	tiền lương, tiền công
wagon	toa xe
waist	eo, chỗ thắt lưng
wait	chờ đợi
waiter, waitress	người hầu bàn, người đợi, người trông chờ
wake	thức dậy, tỉnh thức
walk	đi, đi bộ, sự đi bộ, sự đi dạo
walking	sự đi, sự đi bộ
wall	tường, vách
wallet	cái ví
wander	đi lang thang, sự đi lang thang
want	muốn
war	chiến tranh
warehouse	kho
warm	ấm, ấm áp, làm cho nóng, hâm nóng
warmth	trạng thái ấm, sự ấm áp, hơi ấm
warn	báo cho biết, cảnh báo
warning	sự báo trước, lời cảnh báo
warrior	chiến binh
wash	rửa, giặt
washing	sự tắm rửa, sự giặt
waste	lãng phí, uổng phí, vùng hoang vu, sa mạc, bỏ hoang
watch	nhìn, theo dõi, quan sát, sự canh gác, sự canh phòng
water	nước
wave	sóng, gợn nước, gợn sóng, uốn thành sóng
way	đường, đường đi
we	chúng tôi, chúng ta
weak	yếu, yếu ớt
weaken	làm suy yếu
weakness	tình trạng yếu đuối, yếu ớt
wealth	sự giàu có, sự giàu sang
wealthy	giàu có
weapon	vũ khí
wear	mặc, mang, đeo
weather	thời tiết
weave	dệt
web	mạng, lưới
wedding	lễ cưới, hôn lễ
wednesday	thứ 4
weed	cỏ dại
week	tuần, tuần lễ
weekend	cuối tuần
weekly	mỗi tuần một lần, hàng tuần
weigh	cân, cân nặng
weight	trọng lượng
weird	kỳ dị
welcome	chào mừng, hoan nghênh
welfare	phúc lợi
well	tốt, giỏi, ôi, may quá!
well known	nổi tiếng, được nhiều người biết đến
well-being	hạnh phúc
well-known	nổi tiếng
west	phía tây, theo phía tây, về hướng tây
western	về phía tây, của phía tây
wet	ướt, ẩm ướt
whale	cá voi
what	gì, thế nào
whatever	bất cứ thứ gì, bất kể thứ gì
wheat	lúa mì
wheel	bánh xe
wheelchair	xe lăn
when	khi, lúc, vào lúc nào
whenever	bất cứ lúc nào, lúc nào
where	đâu, ở đâu, nơi mà
whereas	nhưng ngược lại, trong khi
wherever	ở bất cứ nơi nào, ở bất cứ nơi đâu
whether	có..không, có... chăng, không biết có.. không
which	nào, bất cứ.. nào, ấy, đó
while	trong lúc, trong khi, lúc, chốc, lát
whilst	trong lúc, trong khi
whip	roi da
whisper	nói thì thầm, xì xào, tiếng nói thì thầm, tiếng xì xào
whistle	sự huýt sáo, sự thổi còi, huýt sáo, thổi còi
white	trắng, màu trắng
who	ai, người nào, kẻ nào, người như thế nàow
whoever	bất cứ ai
whole	bình an vô sự, không suy suyển, không hư hỏng, toàn bộ, tất cả, toàn thể
whom	ai, người nào, người mà
whose	của ai
why	tại sao, vì sao
wide	rộng, rộng lớn
widely	nhiều, xa, rộng rãi
widespread	phổ biến rộng rãi
widow	người đàn bà góa
width	tính chất rộng, bề rộng
wife	vợ
wild	dại, hoang
wilderness	hoang dã
wildlife	động vật hoang dã
wildly	dại, hoang
will	sẽ
will modal	sẽ, ý chí, ý định
willing	bằng lòng, vui lòng, muốn
willingly	sẵn lòng, tự nguyện
willingness	sự bằng lòng, sự vui lòng
win	chiếm, đọat, thu được
wind	gió
wind sth up	lên dây, quấn, giải quyết
window	cửa sổ
wine	rượu, đồ uống
wing	cánh, sự bay, sự cất cánh
winner	người thắng cuộc
winning	đang dành thắng lợi, thắng cuộc
winter	mùa đông
wipe	lau
wire	dây
wisdom	sự khôn ngoan
wise	khôn ngoan, sáng suốt, thông thái
wish	ước, mong muốn, sự mong ước, lòng mong muốn
with	với, cùng
withdraw	rút, rút khỏi, rút lui
withdrawal	thu hồi
within	trong vong thời gian, trong khoảng thời gian
without	không, không có
witness	sự làm chứng, bằng chứng, chứng kiến, làm chứng
wolf	chó sói
woman	đàn bà, phụ nữ
wonder	ngạc nhiên, lấy làm lạ, kinh ngạc
wonderful	phi thường, khác thường, kỳ diệu, tuyệt vời
wood	gỗ
wooden	làm bằng gỗ
wool	len
word	từ
work	làm việc, sự làm việc
worker	người lao động
working	sự làm, sự làm việc
workout	tập thể dục
workplace	nơi làm việc
works	công trinh
workshop	xưởng
world	thế giới
worldwide	trên toàn thế giới
worried	bồn chồn, lo nghĩ, tỏ ra lo lắng
worry	lo lắng, suy nghĩ, sự lo lắng, suy nghĩ
worrying	gấy lo lắng, gây lo nghĩ
worship	sự tôn thờ, sự tôn sùng, thờ, thờ phụng, tôn thờ
worth	đáng giá, có giá trị
would	sẽ
wound	vết thương, thương tích, làm bị thường, gây thương tích
wounded	bị thương
wow	wow
wrap	gói, bọc, quấn
wrapping	vật bao bọc, vật quấn quanh
wrist	cổ tay
write	viết
writer	người viết
writing	sự viết
written	viết ra, được thảo ra
wrong	sai
wrongly	một cách bất công, không đúng
yard	lat, thước anh
yawn	há miệng, cử chỉ ngáp
yeah	yeah
yeah exclamation	vâng, ừ
year	năm
yell	hét lên
yellow	vàng, màu vàng
yes	vâng, phải, có chứ
yesterday	hôm qua
yet	còn, hãy cỏn, còn nữa, như mà, xong, tuy thế, tuy nhiên
yield	năng suất
you	bạn
young	trẻ, trẻ tuổi, thanh niên
youngster	thiếu niên
your	của bạn
yours	cái của bạn
yours sincerely	bạn chân thành của anh, chị..
yourself	tự anh, tự chị, chính anh, chính mày, tự mày, tự mình
youth	tuổi trẻ, tuổi xuân, tuổi thanh niên, tuổi niên thiếu
zero number	số không
zone	khu vực, miền, vùng
